Id,Label,timeset,indegree,outdegree,Degree,weighted indegree,weighted outdegree,Weighted Degree,Eccentricity,closnesscentrality,harmonicclosnesscentrality,betweenesscentrality,modularity_class,pageranks
000nox,,,0,3,3,0,4,4,1,1,1,0,77,0.00018
AghBahman,,,16,0,16,16,0,16,0,0,0,0,77,0.00217
boiereihan,,,2,0,2,2,0,2,0,0,0,0,77,0.000309
mmoeeni,,,9,0,9,18,0,18,0,0,0,0,77,0.001049
00kennyy,,,0,2,2,0,3,3,1,1,1,0,18,0.00018
Saeed0f,,,6,0,6,6,0,6,0,0,0,0,18,0.000717
fiureh,,,5,0,5,6,0,6,0,0,0,0,18,0.000482
01101011_011100,,,0,1,1,0,1,1,1,1,1,0,18,0.00018
Alone_Solipsist,,,2,0,2,2,0,2,0,0,0,0,18,0.000386
01BinarySoul,,,0,1,1,0,1,1,1,1,1,0,0,0.00018
lTheMightyMl,,,1,0,1,1,0,1,0,0,0,0,0,0.000334
021babak,,,0,1,1,0,1,1,1,1,1,0,18,0.00018
khabarbin,,,27,0,27,34,0,34,0,0,0,0,18,0.001745
021jupiter,,,0,1,1,0,3,3,1,1,1,0,95,0.00018
samanehabibiii,,,10,0,10,30,0,30,0,0,0,0,95,0.000541
07Nomos,,,0,2,2,0,3,3,1,1,1,0,18,0.00018
Lutherking4U,,,52,0,52,90,0,90,0,0,0,0,18,0.003753
Rayan9717,,,6,0,6,6,0,6,0,0,0,0,18,0.000629
0FVV8ptSdVmkRuP,,,1,1,2,1,1,2,0,0,0,0,1,0.00018
0GIvz3OaaPzv0l8,,,0,1,1,0,1,1,1,1,1,0,2,0.00018
FaranakAzad1,,,1,0,1,1,0,1,0,0,0,0,2,0.000334
0Retweeted,,,0,12,12,0,22,22,2,0.875,0.928571,0,95,0.00018
Alirezahse,,,10,4,14,24,13,37,1,1,1,23,95,0.000422
E_ALIPOOR2,,,2,2,4,2,2,4,1,1,1,0,95,0.000193
Reihaneasgari,,,9,0,9,18,0,18,0,0,0,0,95,0.000737
Rohan_IR,,,8,0,8,8,0,8,0,0,0,0,95,0.000719
behranvand,,,2,0,2,2,0,2,0,0,0,0,95,0.000246
deymahi76,,,1,0,1,2,0,2,0,0,0,0,95,0.000193
kal_keley,,,43,0,43,43,0,43,0,0,0,0,95,0.002608
maragheh_313m,,,4,0,4,8,0,8,0,0,0,0,95,0.000279
reyhan_r2572,,,10,0,10,10,0,10,0,0,0,0,95,0.000315
sayeneshiiin,,,5,0,5,12,0,12,0,0,0,0,95,0.00038
somi_morovati,,,7,0,7,14,0,14,0,0,0,0,95,0.000625
sydrazi,,,12,0,12,24,0,24,0,0,0,0,95,0.000979
0Retweeter,,,0,3,3,0,6,6,1,1,1,0,95,0.00018
cyber03130,,,1,0,1,2,0,2,0,0,0,0,95,0.000232
hosseini_info,,,22,0,22,55,0,55,0,0,0,0,95,0.001834
m_khodaverdian,,,1,0,1,2,0,2,0,0,0,0,95,0.000232
0TIXHHG96EI5KtK,,,0,1,1,0,1,1,1,1,1,0,18,0.00018
shayan_shahnazi,,,40,0,40,48,0,48,0,0,0,0,18,0.002635
0fM0nteCrist0,,,0,1,1,0,2,2,1,1,1,0,77,0.00018
alimojtahedzade,,,22,0,22,33,0,33,0,0,0,0,77,0.00253
0jbEReO6XZTYrLp,,,0,1,1,0,1,1,1,1,1,0,95,0.00018
A_poormasood,,,47,0,47,47,0,47,0,0,0,0,95,0.00474
0kbashe,,,0,1,1,0,1,1,1,1,1,0,77,0.00018
0kermanshahi007,,,0,3,3,0,7,7,1,1,1,0,18,0.00018
RefaeiMahdi,,,12,0,12,26,0,26,0,0,0,0,18,0.000976
YaarDabestaani,,,27,0,27,108,0,108,0,0,0,0,18,0.001893
mortezaesmilpor,,,35,0,35,36,0,36,0,0,0,0,18,0.002587
0u9IxZLnw4VKk7r,,,0,1,1,0,1,1,1,1,1,0,18,0.00018
Fakhravar,,,35,1,36,92,1,93,0,0,0,0,18,0.003297
0x__dead,,,0,4,4,0,6,6,2,0.666667,0.75,0,18,0.00018
AMG97988771,,,52,5,57,61,15,76,1,1,1,199,18,0.003569
Godlessam,,,80,0,80,80,0,80,0,0,0,0,18,0.006778
ahmatagha,,,60,0,60,120,0,120,0,0,0,0,18,0.004319
haghnegar,,,36,0,36,76,0,76,0,0,0,0,18,0.002379
100barg,,,0,2,2,0,2,2,1,1,1,0,18,0.00018
Javanmardi75,,,6,0,6,6,0,6,0,0,0,0,18,0.000847
sh_iranii_iii,,,41,0,41,41,0,41,0,0,0,0,18,0.004223
101gholami,,,0,2,2,0,4,4,1,1,1,0,95,0.00018
narangi_,,,3,0,3,6,0,6,0,0,0,0,95,0.000456
sadegh_tehrani,,,3,0,3,6,0,6,0,0,0,0,95,0.000312
110sayyad110,,,0,1,1,0,2,2,1,1,1,0,95,0.00018
givehki,,,3,0,3,6,0,6,0,0,0,0,95,0.000395
11o_nim,,,0,2,2,0,2,2,1,1,1,0,18,0.00018
I6_6_6I,,,10,0,10,10,0,10,0,0,0,0,18,0.001315
WinsWolfe,,,36,0,36,36,0,36,0,0,0,0,18,0.003915
12gandi,,,0,1,1,0,1,1,1,1,1,0,18,0.00018
133Rezvani,,,0,2,2,0,4,4,1,1,1,0,95,0.00018
rahimporazghadi,,,6,0,6,18,0,18,0,0,0,0,95,0.000847
torkaman_m,,,1,0,1,1,0,1,0,0,0,0,95,0.000257
1351Alireza,,,0,3,3,0,7,7,1,1,1,0,18,0.00018
ParthianE,,,18,0,18,51,0,51,0,0,0,0,18,0.001122
homa53387030,,,1,0,1,1,0,1,0,0,0,0,18,0.000232
smartrobott,,,29,0,29,87,0,87,0,0,0,0,18,0.001941
1352j,,,0,1,1,0,1,1,1,1,1,0,18,0.00018
1364Baran,,,0,6,6,0,13,13,1,1,1,0,95,0.00018
Emohammadi8,,,2,1,3,4,2,6,0,0,0,0,95,0.000206
GhAbdollahi313,,,1,0,1,2,0,2,0,0,0,0,95,0.000206
RashiiidAzari,,,3,0,3,6,0,6,0,0,0,0,95,0.000235
emad_ameri,,,18,0,18,38,0,38,0,0,0,0,95,0.001368
mohamad_h_s,,,20,0,20,60,0,60,0,0,0,0,95,0.000639
1369khakbary,,,0,1,1,0,1,1,1,1,1,0,3,0.00018
shahabsmam,,,2,0,2,2,0,2,0,0,0,0,3,0.000411
1394nasim,,,0,6,6,0,10,10,1,1,1,0,95,0.00018
bicaran,,,1,0,1,2,0,2,0,0,0,0,95,0.000206
esfahani07498,,,4,0,4,6,0,6,0,0,0,0,95,0.000375
khorammanesh,,,23,0,23,29,0,29,0,0,0,0,95,0.000711
mmaahhdi44,,,3,0,3,4,0,4,0,0,0,0,95,0.000238
mojtabarajabi26,,,2,0,2,2,0,2,0,0,0,0,95,0.00036
workernioc,,,1,0,1,2,0,2,0,0,0,0,95,0.000206
1397_sara,,,1,1,2,2,2,4,1,1,1,0.5,95,0.000183
yasin123345,,,2,0,2,4,0,4,0,0,0,0,95,0.000642
1398Ho,,,0,2,2,0,3,3,1,1,1,0,4,0.00018
goolnakhor2,,,2,0,2,2,0,2,0,0,0,0,4,0.000411
heisenbeg,,,2,0,2,3,0,3,0,0,0,0,4,0.000334
14KUMAIL,,,0,1,1,0,1,1,1,1,1,0,95,0.00018
Bisimchiimedia,,,5,0,5,5,0,5,0,0,0,0,95,0.000489
15_mamad,,,0,1,1,0,1,1,1,1,1,0,5,0.00018
potanciel,,,3,0,3,3,0,3,0,0,0,0,5,0.000642
17Alio17,,,0,1,1,0,1,1,1,1,1,0,6,0.00018
26Mammadov,,,1,0,1,1,0,1,0,0,0,0,6,0.000334
1877Nima,,,0,1,1,0,1,1,1,1,1,0,77,0.00018
bikaranejaan,,,42,0,42,43,0,43,0,0,0,0,77,0.005581
1970ahmadian,,,0,1,1,0,1,1,1,1,1,0,7,0.00018
kamyar_sabahi,,,1,0,1,1,0,1,0,0,0,0,7,0.000334
1982tabriz,,,0,1,1,0,2,2,1,1,1,0,18,0.00018
e_k_azad,,,24,0,24,48,0,48,0,0,0,0,18,0.003302
1987Mohad,,,0,1,1,0,2,2,1,1,1,0,95,0.00018
MostafaPirhaya3,,,11,0,11,20,0,20,0,0,0,0,95,0.000802
198_sobhan,,,0,4,4,0,6,6,1,1,1,0,8,0.00018
Milad96_Rahmani,,,1,0,1,2,0,2,0,0,0,0,8,0.000219
Nika_M97,,,1,0,1,1,0,1,0,0,0,0,8,0.000219
Shokranebanoo,,,1,0,1,2,0,2,0,0,0,0,8,0.000219
bachetiroon,,,1,0,1,1,0,1,0,0,0,0,8,0.000219
1995Civil,,,0,3,3,0,5,5,1,1,1,0,95,0.00018
Masoudbassiri,,,6,0,6,12,0,12,0,0,0,0,95,0.000679
pakhmekhan,,,8,0,8,8,0,8,0,0,0,0,95,0.000351
sajjad_rezaei12,,,2,0,2,4,0,4,0,0,0,0,95,0.000233
1995_mol,,,0,1,1,0,1,1,1,1,1,0,77,0.00018
Gavrch,,,20,0,20,20,0,20,0,0,0,0,77,0.002516
1Bad_Khat,,,0,1,1,0,1,1,1,1,1,0,77,0.00018
Mr_lanturi,,,15,0,15,15,0,15,0,0,0,0,77,0.00187
1Barandaz,,,0,10,10,0,10,10,1,1,1,0,18,0.00018
MrDariushZand,,,6,0,6,6,0,6,0,0,0,0,18,0.000487
SaberBostaniAsl,,,6,0,6,12,0,12,0,0,0,0,18,0.000417
TheIntangibles,,,26,0,26,34,0,34,0,0,0,0,18,0.001706
Tyler_3xT,,,13,0,13,16,0,16,0,0,0,0,18,0.000896
alirezakiani2,,,8,0,8,8,0,8,0,0,0,0,18,0.000824
dnravi23,,,24,0,24,24,0,24,0,0,0,0,18,0.001477
erfan_kasraie,,,7,0,7,7,0,7,0,0,0,0,18,0.000622
kamranayazi69,,,9,0,9,10,0,10,0,0,0,0,18,0.000914
1DqSV9U8YEnk7NI,,,0,1,1,0,1,1,1,1,1,0,9,0.00018
kimsesiz_bey,,,2,0,2,2,0,2,0,0,0,0,9,0.000488
1M_mehdi_B7,,,0,1,1,0,1,1,1,1,1,0,95,0.00018
khanom_sad,,,10,0,10,10,0,10,0,0,0,0,95,0.000563
1Zartosht,,,0,1,1,0,1,1,1,1,1,0,77,0.00018
EbneHava,,,50,1,51,50,1,51,0,0,0,0,77,0.005138
1haddiseshoon,,,0,1,1,0,1,1,1,1,1,0,77,0.00018
1ife_st0ry,,,0,1,1,0,1,1,1,1,1,0,18,0.00018
1jangjo,,,0,2,2,0,5,5,2,0.75,0.833333,0,18,0.00018
Babak_1992,,,37,1,38,74,2,76,1,1,1,37,18,0.002778
1jo5XsMeuhpsp57,,,0,3,3,0,5,5,1,1,1,0,18,0.00018
kingofk_kings,,,24,0,24,40,0,40,0,0,0,0,18,0.002132
william5wallase,,,25,0,25,68,0,68,0,0,0,0,18,0.001464
1manoosh1,,,0,1,1,0,1,1,1,1,1,0,10,0.00018
jimmishh,,,1,0,1,1,0,1,0,0,0,0,10,0.000334
1mskv9,,,0,1,1,0,1,1,1,1,1,0,152,0.00018
PEDIiISH,,,2,0,2,2,0,2,0,0,0,0,152,0.000621
1twiteruser,,,0,2,2,0,2,2,1,1,1,0,18,0.00018
Grzecznyhastam,,,8,0,8,8,0,8,0,0,0,0,18,0.000819
Pari03580542,,,1,0,1,1,0,1,0,0,0,0,18,0.000257
2000dariush,,,0,1,1,0,1,1,1,1,1,0,18,0.00018
searusM,,,4,0,4,4,0,4,0,0,0,0,18,0.000429
20066Farzan,,,0,1,1,0,1,1,1,1,1,0,11,0.00018
Afraafrasb,,,1,0,1,1,0,1,0,0,0,0,11,0.000334
2006_lebanon,,,0,2,2,0,3,3,1,1,1,0,95,0.00018
Hajsaaleh,,,2,0,2,4,0,4,0,0,0,0,95,0.000411
2018_bahar,,,0,3,3,0,3,3,1,1,1,0,12,0.00018
Maryam_Rajavi_P,,,47,0,47,48,0,48,0,0,0,0,12,0.005962
hambastegi_meli,,,1,0,1,1,0,1,0,0,0,0,12,0.000232
simayazaditv,,,9,0,9,12,0,12,0,0,0,0,12,0.000869
2020AZADI,,,0,2,2,0,6,6,1,1,1,0,18,0.00018
MozdurShenas,,,9,0,9,17,0,17,0,0,0,0,18,0.000644
232babate,,,0,1,1,0,1,1,2,0.571429,0.625,0,18,0.00018
Aleksandra6712,,,2,4,6,2,7,9,1,1,1,3,18,0.000334
2500Years,,,0,1,1,0,1,1,1,1,1,0,18,0.00018
27masouda,,,0,1,1,0,1,1,1,1,1,0,77,0.00018
29morgh,,,0,1,1,0,1,1,1,1,1,0,13,0.00018
mahlagha_hs,,,1,0,1,1,0,1,0,0,0,0,13,0.000334
2Kohestan,,,0,2,2,0,4,4,1,1,1,0,18,0.00018
2Nmira,,,0,6,6,0,12,12,1,1,1,0,77,0.00018
ZahraJafarniya,,,2,0,2,3,0,3,0,0,0,0,77,0.00036
amiramiri164,,,1,0,1,5,0,5,0,0,0,0,77,0.000206
baranbahary1333,,,1,0,1,2,0,2,0,0,0,0,77,0.000206
emad_sh_74,,,1,0,1,1,0,1,0,0,0,0,77,0.000206
fariba139701,,,1,0,1,2,0,2,0,0,0,0,77,0.000206
2PeggMRD,,,0,1,1,0,2,2,1,1,1,0,77,0.00018
ZiaNabavi1,,,26,0,26,52,0,52,0,0,0,0,77,0.003641
2XR1qsCli5v9fko,,,0,1,1,0,2,2,1,1,1,0,95,0.00018
ShKiism,,,2,0,2,6,0,6,0,0,0,0,95,0.000365
2_goleyas,,,0,5,5,0,9,9,1,1,1,0,95,0.00018
Sasan_Soroosh,,,13,0,13,16,0,16,0,0,0,0,95,0.000945
aflakaflaki,,,1,0,1,1,0,1,0,0,0,0,95,0.000211
ashtary57,,,2,0,2,6,0,6,0,0,0,0,95,0.000263
dr_moosavi,,,5,0,5,10,0,10,0,0,0,0,95,0.000331
rajavi_m,,,23,0,23,23,0,23,0,0,0,0,95,0.001157
2_zahra_2,,,0,1,1,0,2,2,1,1,1,0,77,0.00018
2ayyy,,,0,3,3,0,5,5,1,1,1,0,18,0.00018
sheshgalani,,,28,0,28,56,0,56,0,0,0,0,18,0.002778
2darebaz,,,0,1,1,0,2,2,1,1,1,0,14,0.00018
s_mhajiabadi,,,1,0,1,2,0,2,0,0,0,0,14,0.000334
2lightseeker,,,0,1,1,0,2,2,1,1,1,0,95,0.00018
TohidAzizi1357,,,33,0,33,80,0,80,0,0,0,0,95,0.003043
2nJose,,,0,1,1,0,1,1,1,1,1,0,18,0.00018
30Na_ra,,,0,1,1,0,1,1,1,1,1,0,18,0.00018
30laam,,,0,1,1,0,1,1,1,1,1,0,77,0.00018
30na60,,,0,2,2,0,2,2,2,0.75,0.833333,0,18,0.00018
BacheGorbe,,,2,1,3,2,1,3,1,1,1,1,18,0.00027
30second_so,,,0,1,1,0,1,1,1,1,1,0,18,0.00018
30talopram,,,0,2,2,0,2,2,1,1,1,0,18,0.00018
313Hamidreza,,,0,1,1,0,1,1,1,1,1,0,95,0.00018
313Mahdiyaar,,,0,2,2,0,5,5,1,1,1,0,15,0.00018
KhodadadiZohreh,,,1,0,1,2,0,2,0,0,0,0,15,0.000257
Mahdiyaar313,,,1,0,1,3,0,3,0,0,0,0,15,0.000257
313Solder,,,0,5,5,0,10,10,2,0.857143,0.916667,0,95,0.00018
F6sadeghi,,,4,1,5,8,2,10,1,1,1,4,95,0.00025
Nvd3141,,,7,0,7,27,0,27,0,0,0,0,95,0.000358
RW26nxioRVAC5iN,,,1,0,1,1,0,1,0,0,0,0,95,0.000211
URFMcwot3pRzD1a,,,2,0,2,2,0,2,0,0,0,0,95,0.000233
mehdiahmadi110,,,2,0,2,6,0,6,0,0,0,0,95,0.000214
3242832428mgh,,,0,2,2,0,3,3,1,1,1,0,18,0.00018
33salegi,,,8,4,12,9,6,15,1,1,1,47,95,0.000321
Aliei96,,,3,0,3,8,0,8,0,0,0,0,95,0.00048
Bna_am,,,2,0,2,2,0,2,0,0,0,0,95,0.00025
mebrahimi123,,,10,0,10,16,0,16,0,0,0,0,95,0.000361
3Dalahou,,,0,2,2,0,2,2,1,1,1,0,18,0.00018
MrCyberAvenger,,,12,0,12,12,0,12,0,0,0,0,18,0.001194
eLy4RNbUHC9cLzR,,,10,0,10,23,0,23,0,0,0,0,18,0.000696
3Reza2019,,,1,1,2,1,1,2,0,0,0,0,16,0.00018
3YeRZmpOC9thR0P,,,1,5,6,5,11,16,1,1,1,5,18,0.000185
DireDoor,,,1,0,1,2,0,2,0,0,0,0,18,0.000212
MohammadZnd,,,1,0,1,4,0,4,0,0,0,0,18,0.000212
shafieikia,,,1,0,1,1,0,1,0,0,0,0,18,0.000212
3dZendani,,,0,1,1,0,1,1,1,1,1,0,18,0.00018
Saman15216939,,,3,0,3,3,0,3,0,0,0,0,18,0.000565
3erendipity,,,0,1,1,0,1,1,1,1,1,0,18,0.00018
3ghatrekhoon,,,0,2,2,0,2,2,1,1,1,0,18,0.00018
badkhah,,,4,0,4,4,0,4,0,0,0,0,18,0.000356
3p5ThWmxMCZvbPy,,,0,3,3,0,6,6,1,1,1,0,95,0.00018
PooyaHoma2,,,8,0,8,16,0,16,0,0,0,0,95,0.0006
Tahabagheri8210,,,21,0,21,42,0,42,0,0,0,0,95,0.001977
nazanin8565,,,2,0,2,4,0,4,0,0,0,0,95,0.000386
3toode,,,0,3,3,0,4,4,1,1,1,0,18,0.00018
Mahbobe6,,,6,0,6,6,0,6,0,0,0,0,18,0.000327
4018Z,,,1,4,5,1,4,5,1,1,1,4,18,0.000211
irostam1,,,1,0,1,1,0,1,0,0,0,0,18,0.000226
mojtabammmm,,,1,0,1,1,0,1,0,0,0,0,18,0.000226
s_s2sss,,,1,0,1,1,0,1,0,0,0,0,18,0.000226
4BlSi3HCJPYhpYp,,,0,1,1,0,2,2,1,1,1,0,95,0.00018
4R2CBqNIvdaxDEC,,,0,4,4,0,7,7,1,1,1,0,18,0.00018
Mim_Aleff,,,47,0,47,48,0,48,0,0,0,0,18,0.003503
ghasedakekochak,,,4,0,4,5,0,5,0,0,0,0,18,0.000424
4apish,,,0,1,1,0,1,1,1,1,1,0,17,0.00018
sinavaliollah,,,1,0,1,1,0,1,0,0,0,0,17,0.000334
4hedieh,,,0,7,7,0,7,7,1,1,1,0,18,0.00018
Mehdi_Afraa,,,3,0,3,3,0,3,0,0,0,0,18,0.00023
NavidFarda,,,6,0,6,6,0,6,0,0,0,0,18,0.000654
vali_e_faghih,,,35,0,35,96,0,96,0,0,0,0,18,0.00187
4m1r4m,,,0,1,1,0,1,1,2,0.666667,0.75,0,18,0.00018
Allaholocaust,,,3,1,4,3,1,4,1,1,1,3,18,0.000527
4oejwQRDHZNlX9q,,,0,1,1,0,2,2,1,1,1,0,18,0.00018
512sabzekar,,,0,1,1,0,1,1,1,1,1,0,95,0.00018
tabatabaii_s,,,16,0,16,47,0,47,0,0,0,0,95,0.000865
551Raha,,,0,1,1,0,2,2,1,1,1,0,19,0.00018
jebreili_m,,,1,0,1,2,0,2,0,0,0,0,19,0.000334
56ad10,,,0,1,1,0,2,2,1,1,1,0,77,0.00018
sabaazarpeik,,,8,0,8,16,0,16,0,0,0,0,77,0.001001
57NcOqY5l9Pktdw,,,1,7,8,1,17,18,1,1,1,5,18,0.000198
Amirhoseen_,,,12,0,12,12,0,12,0,0,0,0,18,0.000968
Shahyaaar,,,2,0,2,6,0,6,0,0,0,0,18,0.000235
deafowl,,,2,0,2,4,0,4,0,0,0,0,18,0.000286
mohamad99757842,,,1,0,1,3,0,3,0,0,0,0,18,0.000205
59montazer,,,0,1,1,0,1,1,1,1,1,0,95,0.00018
5avak,,,0,1,1,0,1,1,1,1,1,0,20,0.00018
Sagittarius_A_s,,,1,0,1,1,0,1,0,0,0,0,20,0.000334
5o_RaN,,,0,4,4,0,4,4,2,0.833333,0.9,0,18,0.00018
_Aydiin__,,,3,0,3,3,0,3,0,0,0,0,18,0.000382
_Shiaf,,,2,0,2,2,0,2,0,0,0,0,18,0.000373
60DOOL,,,0,1,1,0,2,2,1,1,1,0,18,0.00018
60Genocide,,,0,1,1,0,1,1,1,1,1,0,12,0.00018
PMOIRAN,,,16,0,16,18,0,18,0,0,0,0,12,0.001973
60zqueen,,,0,1,1,0,1,1,1,1,1,0,18,0.00018
63gomnam,,,0,2,2,0,4,4,1,1,1,0,21,0.00018
anvar_bad_87,,,1,0,1,2,0,2,0,0,0,0,21,0.000257
hamidnamdari111,,,1,0,1,2,0,2,0,0,0,0,21,0.000257
65mostafasajadi,,,0,1,1,0,1,1,1,1,1,0,77,0.00018
FarahmandBBC,,,22,0,22,22,0,22,0,0,0,0,77,0.003087
6609a496f47f426,,,0,1,1,0,2,2,1,1,1,0,18,0.00018
66Hossein,,,0,1,1,0,1,1,1,1,1,0,18,0.00018
66__44__22,,,0,1,1,0,1,1,1,1,1,0,18,0.00018
67_ahmadreza,,,0,1,1,0,1,1,1,1,1,0,18,0.00018
67_vahid,,,0,1,1,0,2,2,1,1,1,0,95,0.00018
MohammadVahidii,,,13,0,13,26,0,26,0,0,0,0,95,0.001579
6DZY1hQ2t1u1O28,,,0,2,2,0,8,8,1,1,1,0,95,0.00018
Haji83055690,,,2,0,2,8,0,8,0,0,0,0,95,0.000309
m_h_sheyda,,,4,0,4,8,0,8,0,0,0,0,95,0.000351
6LTOcA91FZBfyno,,,1,1,2,1,1,2,0,0,0,0,22,0.00018
6Pary9,,,2,2,4,2,3,5,1,1,1,4,18,0.000373
6W5zpmMDtM6bu1F,,,0,1,1,0,1,1,1,1,1,0,18,0.00018
6cS0tBILhcbZcHE,,,0,8,8,0,20,20,1,1,1,0,95,0.00018
Dariushjozestan,,,4,0,4,11,0,11,0,0,0,0,95,0.000209
arefamiri14,,,3,0,3,7,0,7,0,0,0,0,95,0.000204
boroumand60,,,1,0,1,3,0,3,0,0,0,0,95,0.0002
mz_heidar,,,2,0,2,4,0,4,0,0,0,0,95,0.000277
naeema_esmaeili,,,9,0,9,17,0,17,0,0,0,0,95,0.000849
neda77600,,,1,0,1,3,0,3,0,0,0,0,95,0.0002
seyedmohammad77,,,25,0,25,120,0,120,0,0,0,0,95,0.000994
6hHPE7k4fZBbx81,,,0,2,2,0,2,2,1,1,1,0,18,0.00018
esterahatga2,,,1,0,1,1,0,1,0,0,0,0,18,0.000257
6prvwoRBXvUx71t,,,0,1,1,0,1,1,1,1,1,0,77,0.00018
6terminator6,,,0,1,1,0,2,2,1,1,1,0,95,0.00018
mohajer_ilami,,,9,0,9,19,0,19,0,0,0,0,95,0.000674
727275abcd,,,0,1,1,0,2,2,1,1,1,0,18,0.00018
75Ktf71,,,0,1,1,0,1,1,1,1,1,0,77,0.00018
76_barana,,,0,1,1,0,1,1,2,0.666667,0.75,0,95,0.00018
EFN_HP,,,3,1,4,3,2,5,1,1,1,2.5,95,0.000357
777_ZEE_777,,,0,1,1,0,1,1,1,1,1,0,18,0.00018
RahimHemmati,,,11,0,11,11,0,11,0,0,0,0,18,0.001121
77Barat,,,0,1,1,0,2,2,1,1,1,0,18,0.00018
7DnO2xHATpVRBhl,,,0,1,1,0,1,1,1,1,1,0,23,0.00018
Dr_Daud_Miraki,,,1,0,1,1,0,1,0,0,0,0,23,0.000334
7EuzI06WNQ8nMSc,,,0,2,2,0,2,2,1,1,1,0,18,0.00018
7QXA7x8VDgOTBrK,,,0,1,1,0,1,1,1,1,1,0,95,0.00018
twiitty_bird,,,7,0,7,9,0,9,0,0,0,0,95,0.00041
7e_Mdrtn,,,0,1,1,0,2,2,1,1,1,0,95,0.00018
7eb0f7239f064c5,,,0,1,1,0,1,1,1,1,1,0,18,0.00018
7hqTUnHr1IiDNuH,,,0,2,2,0,4,4,1,1,1,0,18,0.00018
different925,,,3,0,3,7,0,7,0,0,0,0,18,0.000416
7qf2LSoFjsgbhd2,,,0,1,1,0,2,2,1,1,1,0,95,0.00018
AlamdarMoh3en,,,8,0,8,16,0,16,0,0,0,0,95,0.000481
7th_krg,,,0,1,1,0,1,1,1,1,1,0,24,0.00018
sheikhmammad,,,1,0,1,1,0,1,0,0,0,0,24,0.000334
7xlfY0fiufictHJ,,,0,1,1,0,3,3,1,1,1,0,95,0.00018
81hGvOCOatR4x0N,,,0,1,1,0,1,1,1,1,1,0,77,0.00018
82Jj9mOOXI6vhvQ,,,0,1,1,0,1,1,1,1,1,0,95,0.00018
Lnazari4,,,2,0,2,4,0,4,0,0,0,0,95,0.000339
86i7IeeKbTYI33H,,,1,3,4,2,8,10,1,1,1,1,95,0.000181
emit_somayeh,,,15,0,15,16,0,16,0,0,0,0,95,0.00064
h_abdolmanafi,,,2,0,2,4,0,4,0,0,0,0,95,0.000277
88Hasht88,,,0,1,1,0,1,1,1,1,1,0,95,0.00018
88alimehri,,,0,1,1,0,2,2,1,1,1,0,25,0.00018
AdelPeyghami,,,1,0,1,2,0,2,0,0,0,0,25,0.000334
8A6QXhqc6DOEZcK,,,0,1,1,0,1,1,1,1,1,0,95,0.00018
Jahandideh5,,,3,0,3,3,0,3,0,0,0,0,95,0.000361
8NCEJL6HNIm4yp6,,,0,1,1,0,3,3,1,1,1,0,95,0.00018
8baeb69d371a4e8,,,0,2,2,0,4,4,1,1,1,0,18,0.00018
mohmd_mozafari,,,34,0,34,48,0,48,0,0,0,0,18,0.001854
8fMJsKWXxnarDBj,,,0,1,1,0,1,1,2,0.555556,0.6,0,18,0.00018
8x1CALuO6Gu6JTk,,,0,1,1,0,3,3,1,1,1,0,95,0.00018
91Ixx8NPHzGO3On,,,0,1,1,0,11,11,1,1,1,0,95,0.00018
YhbyTQnzRkC5cRM,,,5,0,5,22,0,22,0,0,0,0,95,0.000386
91taba,,,9,1,10,20,4,24,0,0,0,0,77,0.000731
96Ghasem,,,0,2,2,0,3,3,1,1,1,0,77,0.00018
97Revolutionary,,,0,4,4,0,5,5,2,0.666667,0.75,0,18,0.00018
makan1983makan,,,6,0,6,8,0,8,0,0,0,0,18,0.00034
97_muren,,,3,27,30,5,47,52,3,0.666667,0.778986,133,95,0.0002
Fatiimasss,,,13,30,43,20,54,74,2,0.730159,0.815217,391,95,0.00058
Mahdi11865559,,,3,0,3,6,0,6,0,0,0,0,95,0.000194
Modarresi5,,,1,0,1,1,0,1,0,0,0,0,95,0.000187
Reza_Haghjuo,,,5,0,5,6,0,6,0,0,0,0,95,0.000208
aSeyedJalal_ir,,,5,0,5,6,0,6,0,0,0,0,95,0.00021
abookomeyll,,,16,0,16,34,0,34,0,0,0,0,95,0.000539
abozahra135,,,23,0,23,23,0,23,0,0,0,0,95,0.000737
baanooye_irani,,,18,0,18,18,0,18,0,0,0,0,95,0.000682
entezar_1991,,,18,0,18,18,0,18,0,0,0,0,95,0.0004
firouzabadirasa,,,5,0,5,16,0,16,0,0,0,0,95,0.00021
fotros139,,,19,0,19,25,0,25,0,0,0,0,95,0.00064
hasanlotfi9,,,10,0,10,10,0,10,0,0,0,0,95,0.000543
hossein_bomb,,,1,0,1,3,0,3,0,0,0,0,95,0.000187
maha_farvardin,,,8,0,8,16,0,16,0,0,0,0,95,0.000218
mahdi_p72,,,30,0,30,85,0,85,0,0,0,0,95,0.00134
mobarez_85,,,8,0,8,8,0,8,0,0,0,0,95,0.000235
qYzwbRNcvDyLNhJ,,,2,0,2,12,0,12,0,0,0,0,95,0.000188
saeedshams315,,,10,0,10,10,0,10,0,0,0,0,95,0.000402
zad_313,,,1,0,1,1,0,1,0,0,0,0,95,0.000187
9876Asqar,,,0,1,1,0,1,1,1,1,1,0,18,0.00018
98mahyar98,,,0,1,1,0,1,1,1,1,1,0,26,0.00018
MitraSh5,,,1,0,1,1,0,1,0,0,0,0,26,0.000334
98saramansour,,,0,1,1,0,1,1,1,1,1,0,27,0.00018
mostaqelazzaman,,,1,0,1,1,0,1,0,0,0,0,27,0.000334
990O99,,,0,1,1,0,1,1,1,1,1,0,18,0.00018
samharisirani,,,4,0,4,4,0,4,0,0,0,0,18,0.000694
9OqnFKmv6NOi4Q0,,,0,2,2,0,3,3,1,1,1,0,18,0.00018
mohaghghegh,,,8,0,8,9,0,9,0,0,0,0,18,0.00054
pedare_soshia,,,8,0,8,11,0,11,0,0,0,0,18,0.000798
9add94d5f0d24e7,,,0,1,1,0,2,2,1,1,1,0,77,0.00018
9eXdd1WUCI7Vm9U,,,0,2,2,0,4,4,1,1,1,0,95,0.00018
NematianPayam,,,5,0,5,8,0,8,0,0,0,0,95,0.000758
A19Ehsan,,,0,1,1,0,1,1,1,1,1,0,28,0.00018
sootedel97,,,3,0,3,3,0,3,0,0,0,0,28,0.000437
A225800,,,0,19,19,0,34,34,1,1,1,0,18,0.00018
Behnam88986973,,,3,0,3,6,0,6,0,0,0,0,18,0.000373
MamadZar,,,2,0,2,3,0,3,0,0,0,0,18,0.000205
____mania____,,,7,0,7,15,0,15,0,0,0,0,18,0.000366
afshinazizian,,,4,0,4,4,0,4,0,0,0,0,18,0.000309
amir_hasan19,,,2,0,2,2,0,2,0,0,0,0,18,0.000201
hrd13490,,,4,0,4,4,0,4,0,0,0,0,18,0.000419
i_am_iranii,,,1,0,1,1,0,1,0,0,0,0,18,0.000189
kozet_ir,,,5,0,5,5,0,5,0,0,0,0,18,0.000448
mohabbbattt,,,4,0,4,14,0,14,0,0,0,0,18,0.000795
mohammadreza_HR,,,1,0,1,3,0,3,0,0,0,0,18,0.000189
omidrad1331,,,1,0,1,1,0,1,0,0,0,0,18,0.000189
sia19744,,,5,0,5,5,0,5,0,0,0,0,18,0.000406
tanhaasi,,,2,0,2,3,0,3,0,0,0,0,18,0.00024
A2577Al,,,0,1,1,0,2,2,1,1,1,0,18,0.00018
A4Uxyyy927KVxve,,,0,1,1,0,3,3,1,1,1,0,18,0.00018
A73539567,,,1,35,36,2,83,85,2,0.774194,0.854167,0,18,0.00018
Dead_Weight_Z,,,1,3,4,1,4,5,1,1,1,2,18,0.000185
HSetareh,,,1,0,1,1,0,1,0,0,0,0,18,0.000185
JaameJamshid,,,2,7,9,4,17,21,2,0.888889,0.9375,12,18,0.000216
Kachalmoferi,,,1,1,2,1,1,2,1,1,1,1,18,0.000185
L_khov,,,18,0,18,27,0,27,0,0,0,0,18,0.001218
MehradAA,,,1,0,1,1,0,1,0,0,0,0,18,0.000185
MirzaBeneviss,,,4,0,4,31,0,31,0,0,0,0,18,0.000339
Nedadavid7,,,2,0,2,8,0,8,0,0,0,0,18,0.000219
Ram_t_in,,,2,0,2,4,0,4,0,0,0,0,18,0.000237
Robotyno,,,3,0,3,10,0,10,0,0,0,0,18,0.00035
Scorpionofiran1,,,5,0,5,10,0,10,0,0,0,0,18,0.000416
behaak,,,2,0,2,2,0,2,0,0,0,0,18,0.000236
canisthc,,,2,0,2,3,0,3,0,0,0,0,18,0.00019
daryaarmy1,,,1,0,1,1,0,1,0,0,0,0,18,0.000185
ghasemi_mehri,,,1,0,1,2,0,2,0,0,0,0,18,0.000185
hajspil,,,5,0,5,9,0,9,0,0,0,0,18,0.0003
iranazad99,,,1,0,1,1,0,1,0,0,0,0,18,0.000185
khersmehraboon,,,3,0,3,3,0,3,0,0,0,0,18,0.000279
mehdi_jt,,,1,0,1,1,0,1,0,0,0,0,18,0.000185
mikail6646,,,1,0,1,1,0,1,0,0,0,0,18,0.000185
moein_kh,,,5,0,5,15,0,15,0,0,0,0,18,0.000724
movaghatM,,,6,0,6,11,0,11,0,0,0,0,18,0.000416
shakhenabat7,,,1,0,1,1,0,1,0,0,0,0,18,0.000185
sharagim_zand,,,2,0,2,4,0,4,0,0,0,0,18,0.000339
sheykhkambad,,,1,0,1,1,0,1,0,0,0,0,18,0.000185
ssolmazzx,,,1,0,1,1,0,1,0,0,0,0,18,0.000185
tvazaadi,,,1,0,1,2,0,2,0,0,0,0,18,0.000185
AAiran69085362,,,0,4,4,0,5,5,2,0.666667,0.75,0,18,0.00018
AAkradi,,,0,16,16,0,25,25,1,1,1,0,95,0.00018
AMIN_YPF,,,5,0,5,36,0,36,0,0,0,0,95,0.0002
JameZahr,,,1,0,1,1,0,1,0,0,0,0,95,0.00019
MohsenYas64,,,18,0,18,20,0,20,0,0,0,0,95,0.000966
s_h_akbari435,,,9,0,9,9,0,9,0,0,0,0,95,0.000307
saramosavi88,,,3,0,3,4,0,4,0,0,0,0,95,0.000245
AAliabady,,,0,1,1,0,6,6,1,1,1,0,29,0.00018
sarbazegomnam12,,,2,0,2,12,0,12,0,0,0,0,29,0.000488
AAlidai,,,0,1,1,0,2,2,1,1,1,0,77,0.00018
ABALFAZLLL,,,2,4,6,4,7,11,1,1,1,8,95,0.000209
komeil4584,,,1,0,1,1,0,1,0,0,0,0,95,0.000225
ABBASH62,,,0,1,1,0,3,3,1,1,1,0,95,0.00018
takavar313,,,3,0,3,9,0,9,0,0,0,0,95,0.000489
ABRahimGB,,,0,1,1,0,2,2,1,1,1,0,95,0.00018
ABabamirpor,,,1,31,32,1,65,66,3,0.671233,0.789116,0,95,0.00018
1218_ali,,,1,0,1,1,0,1,0,0,0,0,95,0.000185
AqaHossein,,,5,0,5,15,0,15,0,0,0,0,95,0.000357
AsheghShahadat,,,4,8,12,16,22,38,1,1,1,14.666667,95,0.000202
AsmaBahrami,,,5,1,6,15,2,17,1,1,1,4,95,0.000379
Babak_rahmanii,,,1,6,7,6,12,18,2,0.6875,0.772727,9,95,0.000185
KaloutMorteza,,,3,3,6,6,8,14,1,1,1,6,95,0.000186
Majid_Rp74,,,1,0,1,1,0,1,0,0,0,0,95,0.000185
QalamRan,,,1,0,1,5,0,5,0,0,0,0,95,0.000185
R_Taghipour,,,13,0,13,36,0,36,0,0,0,0,95,0.000463
SCwmxkpHxCDm1a1,,,3,0,3,3,0,3,0,0,0,0,95,0.000237
a_amani59,,,5,0,5,24,0,24,0,0,0,0,95,0.000311
ansherli9898,,,1,0,1,2,0,2,0,0,0,0,95,0.000185
hot_sniper,,,7,0,7,42,0,42,0,0,0,0,95,0.000301
m_f_19_18,,,15,0,15,45,0,45,0,0,0,0,95,0.000589
mkarimi8492,,,1,0,1,1,0,1,0,0,0,0,95,0.000185
sarahoushmandi,,,13,0,13,26,0,26,0,0,0,0,95,0.000708
wolfhjdd,,,1,0,1,1,0,1,0,0,0,0,95,0.000185
ABarabary,,,0,1,1,0,1,1,1,1,1,0,30,0.00018
sasun_sasan,,,1,0,1,1,0,1,0,0,0,0,30,0.000334
ACHAEMENID_S,,,0,1,1,0,2,2,2,0.666667,0.75,0,18,0.00018
ADehghandar,,,1,1,2,1,1,2,0,0,0,0,31,0.00018
AE55898891,,,0,1,1,0,1,1,1,1,1,0,18,0.00018
AES2552,,,0,2,2,0,3,3,1,1,1,0,18,0.00018
MRYAZDAN,,,1,0,1,1,0,1,0,0,0,0,18,0.000257
AGachsaran1338,,,0,4,4,0,4,4,1,1,1,0,18,0.00018
Real_Bluewhale,,,2,0,2,3,0,3,0,0,0,0,18,0.00023
aryai203s,,,1,0,1,1,0,1,0,0,0,0,18,0.000219
dashak0l,,,5,0,5,7,0,7,0,0,0,0,18,0.000563
mahdynosiry,,,1,0,1,1,0,1,0,0,0,0,18,0.000219
AGhaffarpure,,,0,1,1,0,1,1,1,1,1,0,95,0.00018
AGharari,,,0,1,1,0,2,2,1,1,1,0,77,0.00018
AH676092,,,0,5,5,0,10,10,1,1,1,0,95,0.00018
dr_a_ganji,,,4,0,4,10,0,10,0,0,0,0,95,0.000352
koshki_s,,,2,0,2,4,0,4,0,0,0,0,95,0.000283
AHMAD3VOOM,,,7,1,8,9,3,12,1,1,1,6.5,95,0.00073
AHMADENEJADEHA,,,0,1,1,0,2,2,1,1,1,0,32,0.00018
mobarezebahari,,,1,0,1,2,0,2,0,0,0,0,32,0.000334
AHampay,,,0,1,1,0,2,2,1,1,1,0,18,0.00018
ShahedAlavi,,,5,0,5,7,0,7,0,0,0,0,18,0.000873
AIDIN_persian,,,0,6,6,0,6,6,2,0.6875,0.772727,0,18,0.00018
Amirferfer,,,1,1,2,1,1,2,1,1,1,1,18,0.000206
MonfaredAshkan,,,2,0,2,3,0,3,0,0,0,0,18,0.000225
Roudaabe,,,6,0,6,6,0,6,0,0,0,0,18,0.000596
AKBARI1397,,,0,2,2,0,4,4,1,1,1,0,95,0.00018
MizanNewsAgency,,,2,0,2,3,0,3,0,0,0,0,95,0.000334
AKhanfiaz,,,0,1,1,0,1,1,1,1,1,0,158,0.00018
zartajgulwazir,,,15,0,15,16,0,16,0,0,0,0,158,0.002489
ALEXAFSOONGAR,,,15,10,25,15,12,27,2,0.916667,0.954545,282.5,18,0.000976
Keykhoon,,,17,1,18,22,2,24,1,1,1,41,18,0.001343
KhalilOghab,,,5,0,5,5,0,5,0,0,0,0,18,0.000616
Mozer_ir,,,1,0,1,1,0,1,0,0,0,0,18,0.000264
SAMEONELIKEME,,,1,0,1,1,0,1,0,0,0,0,18,0.000264
SIAARSHAM,,,2,0,2,2,0,2,0,0,0,0,18,0.000418
Schahrzad_b,,,1,0,1,1,0,1,0,0,0,0,18,0.000264
SomyySomy,,,1,0,1,2,0,2,0,0,0,0,18,0.000264
davezarei,,,2,0,2,2,0,2,0,0,0,0,18,0.000283
miIitantatheist,,,8,0,8,8,0,8,0,0,0,0,18,0.000682
rezamarmuolak,,,15,0,15,16,0,16,0,0,0,0,18,0.001273
ALGHADI76273794,,,0,3,3,0,5,5,1,1,1,0,95,0.00018
Tahereh561,,,2,0,2,3,0,3,0,0,0,0,95,0.000237
ALiShamim4347,,,0,2,2,0,5,5,1,1,1,0,95,0.00018
AMADEIM_FARMAND,,,0,1,1,0,1,1,1,1,1,0,95,0.00018
AMA_165AJAN,,,0,11,11,0,21,21,2,0.923077,0.958333,0,95,0.00018
EjackSRT,,,1,1,2,4,1,5,1,1,1,1,95,0.000194
Niayesh_2020,,,7,0,7,14,0,14,0,0,0,0,95,0.000526
Sahel1215R,,,1,0,1,2,0,2,0,0,0,0,95,0.000194
Sezza118_118,,,4,0,4,8,0,8,0,0,0,0,95,0.000579
ShahadatArezom,,,1,0,1,1,0,1,0,0,0,0,95,0.000194
golestani1414,,,3,0,3,6,0,6,0,0,0,0,95,0.00031
hejab_313,,,3,0,3,3,0,3,0,0,0,0,95,0.000228
sarbaze12__2,,,3,0,3,8,0,8,0,0,0,0,95,0.000202
vaheedsafaei,,,3,0,3,6,0,6,0,0,0,0,95,0.00024
SETAREH2538,,,5,0,5,14,0,14,0,0,0,0,18,0.00113
pabedar,,,15,0,15,21,0,21,0,0,0,0,18,0.001568
un_world_org,,,4,0,4,8,0,8,0,0,0,0,18,0.000847
AMIR197909262,,,2,1,3,4,2,6,0,0,0,0,33,0.000232
AMIRRETWITE,,,1,3,4,2,6,8,1,1,1,0,33,0.00018
IRANRETWITE,,,2,1,3,4,2,6,0,0,0,0,33,0.000232
AMIR__J,,,0,1,1,0,1,1,1,1,1,0,95,0.00018
fereshteh_m_j,,,2,0,2,2,0,2,0,0,0,0,95,0.000335
AMMAR11015,,,0,1,1,0,2,2,1,1,1,0,95,0.00018
AMajidirad,,,0,1,1,0,2,2,2,0.571429,0.625,0,95,0.00018
AManaghebi,,,0,1,1,0,1,1,1,1,1,0,77,0.00018
AMohammsdi,,,0,1,1,0,1,1,1,1,1,0,12,0.00018
AMoradi65,,,0,2,2,0,2,2,1,1,1,0,95,0.00018
Mohyioddin,,,2,0,2,2,0,2,0,0,0,0,95,0.000296
AN8HBsJHf9SycyK,,,0,7,7,0,12,12,1,1,1,0,95,0.00018
GomnamAmadim,,,2,0,2,2,0,2,0,0,0,0,95,0.000203
atefe422,,,7,0,7,15,0,15,0,0,0,0,95,0.000571
labkhandebasije,,,1,0,1,3,0,3,0,0,0,0,95,0.000202
martinhaji,,,3,0,3,9,0,9,0,0,0,0,95,0.000289
morteza_rayati,,,1,0,1,1,0,1,0,0,0,0,95,0.000202
shafiei_z7787,,,1,0,1,1,0,1,0,0,0,0,95,0.000202
ANTIZIONISMMAN,,,0,1,1,0,1,1,1,1,1,0,95,0.00018
h_mohammadi1372,,,5,0,5,6,0,6,0,0,0,0,95,0.000419
ANVAR_VELAYAT,,,0,2,2,0,3,3,1,1,1,0,95,0.00018
AOmidvand,,,0,1,1,0,3,3,1,1,1,0,77,0.00018
AbdolrezaDavari,,,11,0,11,31,0,31,0,0,0,0,77,0.00099
APanjom,,,0,1,1,0,1,1,2,0.555556,0.6,0,18,0.00018
APayrovy,,,0,1,1,0,1,1,1,1,1,0,18,0.00018
ASRIONEE,,,0,1,1,0,2,2,1,1,1,0,95,0.00018
AShahadat110,,,0,14,14,0,20,20,1,1,1,0,95,0.00018
mim_mesbah,,,6,0,6,6,0,6,0,0,0,0,95,0.000214
ASinaa06636766,,,0,1,1,0,4,4,1,1,1,0,18,0.00018
ATP68400769,,,0,6,6,0,11,11,1,1,1,0,18,0.00018
ATTIQ98231058,,,0,1,1,0,1,1,1,1,1,0,158,0.00018
AYWIL12v0NSdQ23,,,0,1,1,0,1,1,1,1,1,0,77,0.00018
AYakhchalian,,,0,2,2,0,3,3,1,1,1,0,18,0.00018
Patient0Zero,,,5,0,5,5,0,5,0,0,0,0,18,0.000694
sahandiranmehr,,,1,0,1,2,0,2,0,0,0,0,18,0.000257
AYeh_66,,,0,12,12,0,28,28,2,0.928571,0.961538,0,95,0.00018
313_salmaneh,,,5,0,5,12,0,12,0,0,0,0,95,0.000543
Dilay1398,,,4,1,5,8,2,10,0,0,0,0,95,0.000203
Pure_Girl110,,,2,0,2,4,0,4,0,0,0,0,95,0.00027
abbasmantaghe,,,5,0,5,15,0,15,0,0,0,0,95,0.000553
baji_uglu,,,1,0,1,2,0,2,0,0,0,0,95,0.000193
delaramhastam,,,1,0,1,2,0,2,0,0,0,0,95,0.000193
AZAGavgvmr6d8RI,,,0,2,2,0,2,2,1,1,1,0,18,0.00018
AZRBD,,,0,1,1,0,2,2,1,1,1,0,34,0.00018
majazestan,,,2,0,2,4,0,4,0,0,0,0,34,0.000488
AZ_ALI77,,,0,1,1,0,1,1,1,1,1,0,77,0.00018
A_B_mashhad,,,0,1,1,0,1,1,1,1,1,0,95,0.00018
A_Brave_Woman,,,0,1,1,0,3,3,1,1,1,0,18,0.00018
A_E_Rasooli,,,0,1,1,0,2,2,1,1,1,0,35,0.00018
hamedzamani_ir,,,1,0,1,2,0,2,0,0,0,0,35,0.000334
A_Ghade,,,0,1,1,0,2,2,1,1,1,0,95,0.00018
m_islami313,,,9,0,9,41,0,41,0,0,0,0,95,0.000586
A_KhodabandehB,,,0,1,1,0,2,2,1,1,1,0,18,0.00018
A_R_SH22,,,0,1,1,0,1,1,1,1,1,0,18,0.00018
A_Rahimlou,,,0,1,1,0,2,2,1,1,1,0,95,0.00018
Me___Ti,,,6,0,6,12,0,12,0,0,0,0,95,0.000705
A_Shokouhmand,,,0,1,1,0,2,2,1,1,1,0,36,0.00018
AbdollahiMohsen,,,1,0,1,2,0,2,0,0,0,0,36,0.000334
A_a1369,,,0,1,1,0,3,3,1,1,1,0,95,0.00018
A_babaei61,,,1,14,15,1,30,31,1,1,1,0,95,0.00018
Payandeh1378,,,2,0,2,4,0,4,0,0,0,0,95,0.000211
SHT97676971,,,1,0,1,3,0,3,0,0,0,0,95,0.000191
el2211331,,,3,0,3,6,0,6,0,0,0,0,95,0.000422
jafar_usf,,,16,0,16,17,0,17,0,0,0,0,95,0.001314
joleia_1,,,2,0,2,6,0,6,0,0,0,0,95,0.000192
mojtaba_solati,,,2,0,2,4,0,4,0,0,0,0,95,0.000211
omid_barahman,,,3,0,3,6,0,6,0,0,0,0,77,0.000274
rasttii,,,2,0,2,6,0,6,0,0,0,0,95,0.000345
A_free_man22,,,0,1,1,0,1,1,1,1,1,0,18,0.00018
loolooyi,,,7,0,7,7,0,7,0,0,0,0,18,0.000527
A_m_n_,,,2,2,4,4,4,8,1,1,1,4,95,0.00026
Mehraskhan7,,,1,0,1,2,0,2,0,0,0,0,95,0.000292
A_mousavi_,,,0,1,1,0,3,3,1,1,1,0,95,0.00018
AaRMaaN1298,,,0,1,1,0,1,1,1,1,1,0,37,0.00018
seyedamiir,,,1,0,1,1,0,1,0,0,0,0,37,0.000334
AaSedMorteza,,,0,4,4,0,5,5,1,1,1,0,18,0.00018
m_r_kachouian,,,6,0,6,6,0,6,0,0,0,0,18,0.000879
sadramsz,,,1,0,1,1,0,1,0,0,0,0,18,0.000219
Aayatollahbbc,,,0,1,1,0,3,3,1,1,1,0,18,0.00018
Ab_Abroshan,,,0,1,1,0,2,2,2,0.538462,0.571429,0,77,0.00018
AfBlack7,,,1,6,7,2,13,15,1,1,1,6,77,0.000334
AbadanMajazi,,,0,1,1,0,2,2,1,1,1,0,38,0.00018
LBarotkob,,,1,0,1,2,0,2,0,0,0,0,38,0.000334
Abadimehdi1,,,0,7,7,0,15,15,2,0.888889,0.9375,0,95,0.00018
Baroooon2,,,3,0,3,3,0,3,0,0,0,0,95,0.000219
YN3s4L5QKeBOMxR,,,3,0,3,6,0,6,0,0,0,0,95,0.000219
asalmoein,,,3,0,3,6,0,6,0,0,0,0,95,0.000282
ya_zeynab111,,,3,0,3,3,0,3,0,0,0,0,95,0.000219
Abadis1390,,,0,2,2,0,5,5,1,1,1,0,18,0.00018
Aban__dokht,,,0,1,1,0,2,2,1,1,1,0,95,0.00018
Abbas35067663,,,0,2,2,0,8,8,2,0.666667,0.75,0,95,0.00018
HAMID_GUARDIAN0,,,12,2,14,18,5,23,1,1,1,30,18,0.001302
AbbasAliSarvi,,,0,1,1,0,2,2,1,1,1,0,39,0.00018
aminsalimi1372,,,1,0,1,2,0,2,0,0,0,0,39,0.000334
AbbasBagherpour,,,1,1,2,3,1,4,1,1,1,2,95,0.000181
AbbasKz97,,,4,3,7,4,5,9,1,1,1,24.5,95,0.0002
S_A_TOOSI,,,1,0,1,1,0,1,0,0,0,0,95,0.000237
AbbasMehrabi74,,,0,1,1,0,3,3,1,1,1,0,95,0.00018
deyacoo001,,,5,0,5,13,0,13,0,0,0,0,95,0.000455
Abbas_Akila_110,,,0,3,3,0,4,4,1,1,1,0,77,0.00018
Evi1356,,,1,0,1,1,0,1,0,0,0,0,77,0.000232
mas00d_mk,,,2,0,2,3,0,3,0,0,0,0,77,0.00027
saman_h66,,,1,0,1,1,0,1,0,0,0,0,77,0.000232
Abbasemami4,,,0,1,1,0,1,1,1,1,1,0,40,0.00018
Rezamehregan1,,,1,0,1,1,0,1,0,0,0,0,40,0.000334
Abbasgodini234,,,0,1,1,0,1,1,1,1,1,0,95,0.00018
Abcxyz19880144,,,0,1,1,0,1,1,1,1,1,0,18,0.00018
AbdiHr7777777,,,0,1,1,0,1,1,1,1,1,0,77,0.00018
AbdollahpourMj,,,0,2,2,0,3,3,1,1,1,0,95,0.00018
Daniel_A110,,,1,0,1,2,0,2,0,0,0,0,95,0.000257
m_ebrahimi7275,,,2,0,2,3,0,3,0,0,0,0,95,0.000258
AbdulBa56079821,,,0,1,1,0,1,1,1,1,1,0,158,0.00018
AbedZr95,,,0,1,1,0,1,1,1,1,1,0,18,0.00018
AbedzadehFarzin,,,0,7,7,0,18,18,6,0.255906,0.342308,0,18,0.00018
AhuraMa59472994,,,3,9,12,4,19,23,5,0.309645,0.399727,177,18,0.000378
KFravahar,,,12,0,12,20,0,20,0,0,0,0,18,0.003333
hamsareloot,,,7,0,7,12,0,12,0,0,0,0,18,0.000693
Abei_am,,,0,1,1,0,2,2,1,1,1,0,95,0.00018
sadin97,,,2,0,2,7,0,7,0,0,0,0,95,0.00034
Abi02050900,,,0,1,1,0,1,1,1,1,1,0,18,0.00018
AbjieDadash,,,0,1,1,0,1,1,1,1,1,0,77,0.00018
Abolfast,,,1,2,3,1,2,3,1,1,1,0,41,0.00018
samconn29147027,,,1,0,1,1,0,1,0,0,0,0,41,0.000257
Abolfazl1989s,,,0,1,1,0,2,2,1,1,1,0,77,0.00018
mim_moghaddam,,,7,0,7,14,0,14,0,0,0,0,77,0.001058
Abolfazl46,,,0,2,2,0,3,3,1,1,1,0,95,0.00018
AbolfazlMm2,,,0,1,1,0,1,1,1,1,1,0,42,0.00018
_sen_yorita,,,1,0,1,1,0,1,0,0,0,0,42,0.000334
AbolfazlMousav9,,,0,1,1,0,1,1,1,1,1,0,95,0.00018
Abomohammad_14,,,2,1,3,2,1,3,0,0,0,0,95,0.000196
AbouMahdi97,,,0,2,2,0,7,7,1,1,1,0,95,0.00018
r_nili,,,6,0,6,18,0,18,0,0,0,0,77,0.000505
Aboutalebi6,,,0,1,1,0,1,1,1,1,1,0,12,0.00018
AbouzarShakeri,,,0,1,1,0,1,1,1,1,1,0,142,0.00018
imantorkashvand,,,8,0,8,8,0,8,0,0,0,0,142,0.001181
Abra2620,,,0,6,6,0,10,10,1,1,1,0,18,0.00018
AbtinAtri,,,0,1,1,0,2,2,2,0.666667,0.75,0,95,0.00018
EbrahimniaIr,,,2,1,3,4,1,5,1,1,1,2,95,0.000411
AbuEbrahim2017,,,1,4,5,3,8,11,1,1,1,4,95,0.000334
Mirmahna_64,,,1,0,1,4,0,4,0,0,0,0,95,0.000252
Abuali_313,,,0,2,2,0,4,4,1,1,1,0,95,0.00018
bekhaterkhoda,,,10,0,10,28,0,28,0,0,0,0,95,0.000737
Achilles8082,,,0,2,2,0,3,3,1,1,1,0,18,0.00018
JAVIDSHAH_IRAN,,,8,0,8,16,0,16,0,0,0,0,18,0.001022
KamBee11,,,3,0,3,4,0,4,0,0,0,0,18,0.000347
ActingPresident,,,0,4,4,0,4,4,1,1,1,0,18,0.00018
kmsddsmk,,,1,0,1,1,0,1,0,0,0,0,18,0.000219
Adalatkhahi,,,0,6,6,0,12,12,1,1,1,0,77,0.00018
Bahar_Media,,,2,0,2,4,0,4,0,0,0,0,77,0.000283
JKangming,,,2,0,2,2,0,2,0,0,0,0,77,0.000283
aminoroaya313,,,2,0,2,2,0,2,0,0,0,0,77,0.000283
zeddezogh,,,4,0,4,8,0,8,0,0,0,0,77,0.000442
AdelTarahomi,,,0,1,1,0,1,1,1,1,1,0,95,0.00018
mjhhorr,,,14,0,14,15,0,15,0,0,0,0,95,0.000677
Adina_ir,,,0,1,1,0,2,2,1,1,1,0,77,0.00018
Admiralchandler,,,1,1,2,1,1,2,0,0,0,0,43,0.00018
AdnankhanSami,,,0,1,1,0,1,1,1,1,1,0,158,0.00018
AeranAerani1,,,0,2,2,0,7,7,1,1,1,0,95,0.00018
Ashegh_enghelab,,,3,1,4,13,2,15,1,1,1,1,95,0.000347
sarbaz_khorshid,,,3,0,3,8,0,8,0,0,0,0,95,0.000632
Aerospace_0_0,,,0,1,1,0,1,1,1,1,1,0,95,0.00018
amirebtehaj,,,22,0,22,22,0,22,0,0,0,0,77,0.002966
hajmoh3en,,,9,0,9,18,0,18,0,0,0,0,77,0.000866
mahditavakkolii,,,1,0,1,2,0,2,0,0,0,0,77,0.000228
Afaresh1,,,0,1,1,0,1,1,1,1,1,0,18,0.00018
Afarinesh114,,,0,2,2,0,3,3,1,1,1,0,95,0.00018
Tasnimnews_Fa,,,9,0,9,20,0,20,0,0,0,0,95,0.000805
AfrasiabiReza,,,0,3,3,0,8,8,1,1,1,0,18,0.00018
MashruteChi,,,1,0,1,3,0,3,0,0,0,0,18,0.000232
Afro_083,,,0,4,4,0,5,5,2,0.833333,0.9,0,18,0.00018
AfsanehOskouei2,,,0,1,1,0,2,2,1,1,1,0,44,0.00018
Shahabeiran,,,1,0,1,2,0,2,0,0,0,0,44,0.000334
Afsaneh_HB,,,0,1,1,0,1,1,1,1,1,0,18,0.00018
Afsar_basirbod,,,0,1,1,0,3,3,1,1,1,0,95,0.00018
AfshadJ,,,0,1,1,0,2,2,2,0.666667,0.75,0,18,0.00018
Afsheenn,,,0,2,2,0,3,3,1,1,1,0,18,0.00018
KMehraboon,,,1,0,1,1,0,1,0,0,0,0,18,0.000257
radioshemroon,,,2,0,2,5,0,5,0,0,0,0,18,0.000417
AfshinRh,,,0,1,1,0,2,2,1,1,1,0,77,0.00018
raeisossadat,,,2,0,2,4,0,4,0,0,0,0,77,0.000411
Afshin_1999,,,0,1,1,0,1,1,1,1,1,0,77,0.00018
Afshin_Mehrdad2,,,0,1,1,0,2,2,1,1,1,0,95,0.00018
Afsoon42186668,,,0,11,11,0,20,20,2,0.923077,0.958333,0,95,0.00018
HKaffashi,,,3,0,3,8,0,8,0,0,0,0,95,0.000351
Masoomeh1995,,,2,0,2,4,0,4,0,0,0,0,95,0.000197
iman78313,,,2,0,2,4,0,4,0,0,0,0,95,0.000197
patriot19863,,,1,0,1,2,0,2,0,0,0,0,95,0.000194
AfzaliKiana,,,0,6,6,0,12,12,2,0.75,0.833333,0,95,0.00018
AsSm313,,,2,4,6,4,6,10,1,1,1,4,95,0.00022
bentolnajaf,,,5,0,5,10,0,10,0,0,0,0,95,0.000502
m_al_abd,,,4,0,4,7,0,7,0,0,0,0,95,0.000405
rhosseini0,,,13,0,13,32,0,32,0,0,0,0,95,0.000919
zeinabsabour,,,3,0,3,6,0,6,0,0,0,0,95,0.000374
Agaesebil1,,,0,7,7,0,8,8,2,0.733333,0.818182,0,18,0.00018
mimk4f,,,3,0,3,3,0,3,0,0,0,0,18,0.000433
saiuron,,,8,0,8,8,0,8,0,0,0,0,18,0.000341
santiaaagoooo,,,3,0,3,3,0,3,0,0,0,0,77,0.000356
velgard100,,,6,0,6,7,0,7,0,0,0,0,18,0.000649
AghJoker,,,0,1,1,0,1,1,1,1,1,0,18,0.00018
kayotRaRa,,,3,0,3,3,0,3,0,0,0,0,18,0.000565
AghPachino,,,4,9,13,8,15,23,3,0.536232,0.603604,579.833333,18,0.000296
Amirzartoshttt,,,3,18,21,3,33,36,2,0.821429,0.891304,435.833333,18,0.000255
Butterfly_6565,,,8,11,19,8,21,29,4,0.425287,0.54955,350.333333,18,0.000558
parya846225185,,,1,0,1,2,0,2,0,0,0,0,18,0.000209
Aghabgard,,,0,1,1,0,2,2,1,1,1,0,18,0.00018
AghaghiGhazali,,,0,1,1,0,1,1,1,1,1,0,18,0.00018
Aghajani_Hassan,,,1,1,2,1,1,2,0,0,0,0,45,0.00018
Agharaouf,,,0,1,1,0,2,2,1,1,1,0,95,0.00018
drcode0,,,2,0,2,4,0,4,0,0,0,0,95,0.000386
AghayeRish,,,0,1,1,0,2,2,1,1,1,0,77,0.00018
Aghmortezam,,,0,1,1,0,1,1,1,1,1,0,77,0.00018
Aghorbani11,,,0,2,2,0,3,3,1,1,1,0,95,0.00018
morsalat74,,,6,0,6,6,0,6,0,0,0,0,95,0.000271
Aghshamgalan,,,0,1,1,0,1,1,1,1,1,0,95,0.00018
AgnelliMartyr,,,1,11,12,4,25,29,1,1,1,9,95,0.000181
Marshall3021,,,1,0,1,1,0,1,0,0,0,0,95,0.000194
Mohammadlotfal2,,,1,0,1,1,0,1,0,0,0,0,95,0.000194
gomnamekomeil,,,7,0,7,21,0,21,0,0,0,0,95,0.000218
Ahadi_Mustafa_S,,,1,1,2,5,5,10,0,0,0,0,46,0.00018
AhangarKavveh,,,0,1,1,0,2,2,1,1,1,0,18,0.00018
Ahlehichestan,,,0,1,1,0,3,3,1,1,1,0,47,0.00018
smhadimousavi,,,2,0,2,6,0,6,0,0,0,0,47,0.000488
Ahmad19162297,,,0,1,1,0,2,2,1,1,1,0,77,0.00018
Ahmad65037261,,,1,7,8,3,15,18,1,1,1,0,12,0.00018
MasoudSattar,,,4,0,4,13,0,13,0,0,0,0,12,0.000446
Minajabbarian,,,4,0,4,4,0,4,0,0,0,0,12,0.000408
AhmadBalochiran,,,0,1,1,0,1,1,1,1,1,0,18,0.00018
night_watch0,,,9,0,9,16,0,16,0,0,0,0,18,0.000791
AhmadBehzadi4,,,0,1,1,0,2,2,2,0.666667,0.75,0,77,0.00018
EEDVARDOO,,,4,2,6,8,3,11,1,1,1,3,77,0.000442
AhmadSiyavashi,,,0,1,1,0,2,2,1,1,1,0,95,0.00018
Ahmad_Atash,,,0,1,1,0,1,1,1,1,1,0,95,0.00018
Ahmadah82590538,,,0,1,1,0,1,1,2,0.555556,0.6,0,18,0.00018
Ahmaddiaspam98,,,0,1,1,0,1,1,1,1,1,0,18,0.00018
Ahmadi6569,,,3,5,8,5,9,14,1,1,1,22,95,0.000334
B_valian,,,1,0,1,3,0,3,0,0,0,0,95,0.000237
Ahmadi97756,,,0,1,1,0,2,2,1,1,1,0,18,0.00018
Javatii1989,,,4,0,4,9,0,9,0,0,0,0,18,0.000565
AhmadiKarim5,,,0,3,3,0,5,5,1,1,1,0,77,0.00018
Ahmadmt16,,,0,1,1,0,2,2,1,1,1,0,48,0.00018
P_Rajabi73,,,2,0,2,4,0,4,0,0,0,0,48,0.000488
Ahmadre88697531,,,0,1,1,0,3,3,1,1,1,0,95,0.00018
ebrahimi313,,,2,0,2,6,0,6,0,0,0,0,95,0.000386
Ahmadreza1419,,,0,1,1,0,1,1,1,1,1,0,95,0.00018
AhmadrezaTheDr,,,0,1,1,0,2,2,2,0.555556,0.6,0,18,0.00018
Ahmadsahlolbei,,,0,1,1,0,1,1,2,0.666667,0.75,0,77,0.00018
Borgeseshoon,,,3,1,4,3,2,5,1,1,1,3,77,0.000565
AhmadyMoustafa,,,0,1,1,0,1,1,1,1,1,0,12,0.00018
Ahoo_2020_Swift,,,0,2,2,0,3,3,1,1,1,0,49,0.00018
HardcorAtheist,,,2,1,3,3,1,4,0,0,0,0,49,0.000257
atheistatoosaa,,,1,0,1,1,0,1,0,0,0,0,49,0.000257
Ahura3,,,0,8,8,0,11,11,2,0.9,0.944444,0,18,0.00018
Amirmovahedia,,,4,0,4,8,0,8,0,0,0,0,12,0.000281
HesamFatemi,,,7,0,7,7,0,7,0,0,0,0,18,0.000786
behrouzaria29,,,6,0,6,6,0,6,0,0,0,0,18,0.000674
7uKqhhrJzkf4IWm,,,1,0,1,1,0,1,0,0,0,0,18,0.000216
Farnoud_Xorsand,,,6,9,15,29,17,46,4,0.392857,0.469697,539.5,18,0.00051
RezaRaha13,,,1,0,1,1,0,1,0,0,0,0,18,0.000216
TheTigerofWS,,,1,0,1,2,0,2,0,0,0,0,18,0.000216
julian_flora,,,1,0,1,1,0,1,0,0,0,0,18,0.000216
Aiande1,,,0,1,1,0,1,1,1,1,1,0,18,0.00018
Aida01697401,,,0,2,2,0,3,3,1,1,1,0,77,0.00018
Aida_hastam,,,0,1,1,0,1,1,1,1,1,0,77,0.00018
AilH_ir,,,0,1,1,0,1,1,1,1,1,0,95,0.00018
Aildrho,,,0,1,1,0,1,1,1,1,1,0,77,0.00018
fatemeekhtesari,,,5,0,5,5,0,5,0,0,0,0,77,0.000562
Aisan1990,,,0,1,1,0,2,2,1,1,1,0,95,0.00018
iman_tavakoli18,,,3,0,3,6,0,6,0,0,0,0,95,0.000338
Ajibzadeh1,,,0,1,1,0,1,1,1,1,1,0,18,0.00018
AkAm66941037,,,0,1,1,0,1,1,1,1,1,0,50,0.00018
Ahmadi199912,,,2,0,2,2,0,2,0,0,0,0,50,0.000488
AkahrinGhadam,,,0,1,1,0,2,2,1,1,1,0,95,0.00018
AkbarAgha5,,,0,1,1,0,2,2,1,1,1,0,18,0.00018
Akharinnaghavi,,,0,1,1,0,2,2,1,1,1,0,51,0.00018
amehokhameh,,,1,0,1,2,0,2,0,0,0,0,51,0.000334
AkhbarFori,,,0,1,1,0,1,1,1,1,1,0,52,0.00018
isna_farsi,,,2,0,2,2,0,2,0,0,0,0,52,0.000488
Akhetochera1,,,0,1,1,0,1,1,1,1,1,0,18,0.00018
Akhond_kosh,,,1,1,2,4,1,5,1,1,1,1,18,0.000207
Akvan_div,,,0,1,1,0,1,1,1,1,1,0,18,0.00018
AlBaLoo9,,,0,1,1,0,1,1,1,1,1,0,77,0.00018
Al_am27,,,1,1,2,2,2,4,0,0,0,0,53,0.00018
Ala6868,,,0,1,1,0,1,1,1,1,1,0,95,0.00018
Alabd114,,,0,2,2,0,12,12,1,1,1,0,95,0.00018
Alale971,,,0,1,1,0,2,2,1,1,1,0,54,0.00018
babak_gholizade,,,1,0,1,2,0,2,0,0,0,0,54,0.000334
AlamshangeM,,,0,10,10,0,15,15,1,1,1,0,95,0.00018
zahra_kh76,,,6,0,6,6,0,6,0,0,0,0,95,0.000271
AlasgarAshiq,,,0,1,1,0,1,1,1,1,1,0,95,0.00018
AlaviEsmaeel,,,0,1,1,0,1,1,1,1,1,0,95,0.00018
AlaviNooshin,,,0,1,1,0,2,2,1,1,1,0,12,0.00018
Alberta64245260,,,0,4,4,0,7,7,1,1,1,0,95,0.00018
Alca_One,,,0,1,1,0,1,1,1,1,1,0,18,0.00018
beehnam,,,4,0,4,4,0,4,0,0,0,0,18,0.000562
Aldo_Apachi22,,,0,2,2,0,2,2,2,0.583333,0.642857,0,18,0.00018
AshaareBeraati,,,1,5,6,1,7,8,1,1,1,5,18,0.000257
Zhekond_28,,,2,0,2,2,0,2,0,0,0,0,18,0.000288
Aleereza3,,,0,1,1,0,1,1,1,1,1,0,77,0.00018
Alex51986657,,,0,5,5,0,5,5,3,0.516129,0.614583,0,18,0.00018
IranianCongress,,,2,0,2,2,0,2,0,0,0,0,18,0.00025
IranianMahyar,,,3,8,11,4,12,16,2,0.733333,0.818182,22,18,0.000288
SilenceVoice00,,,7,0,7,8,0,8,0,0,0,0,18,0.000646
Alexlowe91,,,0,1,1,0,2,2,1,1,1,0,55,0.00018
mehran_sheikhy,,,1,0,1,2,0,2,0,0,0,0,55,0.000334
Alf_the_Frog,,,0,1,1,0,1,1,1,1,1,0,18,0.00018
Alfa12000,,,4,4,8,7,10,17,2,0.666667,0.75,17,18,0.000374
Alfa51599777,,,0,10,10,0,12,12,4,0.433996,0.468403,0,95,0.00018
Asemaneabi222,,,1,9,10,1,17,18,1,1,1,8,95,0.000196
FMirsaeidi,,,3,1,4,3,1,4,1,1,1,3,95,0.000351
Hoosin200400,,,2,158,160,12,309,321,3,0.724684,0.831878,221,95,0.000196
Rahil5256,,,1,0,1,2,0,2,0,0,0,0,95,0.000196
SeyedMa49881064,,,5,0,5,5,0,5,0,0,0,0,95,0.000279
edalat18,,,1,0,1,2,0,2,0,0,0,0,95,0.000196
Alfered666,,,0,1,1,0,2,2,1,1,1,0,18,0.00018
Alfie_Persian92,,,0,1,1,0,1,1,1,1,1,0,18,0.00018
Ali03692894,,,0,2,2,0,6,6,1,1,1,0,95,0.00018
lr_cyber,,,1,0,1,2,0,2,0,0,0,0,95,0.000257
Ali06576119,,,0,1,1,0,1,1,1,1,1,0,18,0.00018
Ali10697648,,,0,1,1,0,1,1,1,1,1,0,18,0.00018
Ali13_78,,,0,1,1,0,1,1,1,1,1,0,77,0.00018
Ali22264142,,,0,1,1,0,4,4,1,1,1,0,18,0.00018
Ali30325464,,,0,2,2,0,5,5,1,1,1,0,95,0.00018
Yasee_Kabood,,,7,0,7,21,0,21,0,0,0,0,95,0.00056
mandegari_mahdi,,,3,0,3,6,0,6,0,0,0,0,95,0.000463
Ali32622143,,,0,1,1,0,1,1,1,1,1,0,56,0.00018
LashkarAfghan,,,1,0,1,1,0,1,0,0,0,0,56,0.000334
Ali43694277,,,0,3,3,0,4,4,1,1,1,0,18,0.00018
Sag_koshi,,,5,0,5,5,0,5,0,0,0,0,18,0.000441
Ali47120402,,,0,1,1,0,1,1,1,1,1,0,57,0.00018
azar_mansoori,,,1,0,1,1,0,1,0,0,0,0,57,0.000334
Ali4834863660,,,0,9,9,0,18,18,1,1,1,0,18,0.00018
samihaastam,,,3,0,3,3,0,3,0,0,0,0,18,0.000292
Ali4lbir,,,0,2,2,0,4,4,1,1,1,0,95,0.00018
asarejoodaki,,,4,0,4,12,0,12,0,0,0,0,95,0.000459
Ali59578007,,,0,11,11,0,18,18,2,0.789474,0.866667,0,18,0.00018
Bugaboo_1990,,,3,0,3,3,0,3,0,0,0,0,18,0.000285
Sima31524136,,,1,0,1,1,0,1,0,0,0,0,18,0.000194
dar_goldan,,,4,0,4,4,0,4,0,0,0,0,18,0.0004
rraaddmman,,,1,0,1,3,0,3,0,0,0,0,18,0.000194
zereshk1357,,,1,0,1,2,0,2,0,0,0,0,18,0.000194
Ali60283441,,,0,1,1,0,3,3,1,1,1,0,12,0.00018
Ali6391436195,,,0,3,3,0,3,3,1,1,1,0,95,0.00018
Ali64571660,,,0,1,1,0,2,2,1,1,1,0,77,0.00018
BonabiMaede,,,2,0,2,4,0,4,0,0,0,0,77,0.000389
Ali65466235,,,0,2,2,0,4,4,1,1,1,0,95,0.00018
Ali69438005,,,0,1,1,0,1,1,1,1,1,0,77,0.00018
Ali70706514,,,0,3,3,0,4,4,1,1,1,0,77,0.00018
ahadShirzad67,,,1,0,1,2,0,2,0,0,0,0,77,0.000232
Ali72048347,,,0,4,4,0,5,5,2,0.833333,0.9,0,18,0.00018
Ali74066460,,,2,2,4,2,2,4,1,1,1,1,18,0.000186
ariyaii_rahjoo,,,1,0,1,1,0,1,0,0,0,0,18,0.00026
Ali87525849,,,0,16,16,0,32,32,2,0.9,0.944444,0,18,0.00018
DariushTusi,,,4,3,7,4,4,8,1,1,1,4,18,0.000289
davwvod,,,4,0,4,5,0,5,0,0,0,0,18,0.000575
sanii1368,,,4,0,4,7,0,7,0,0,0,0,18,0.000251
Ali92570757,,,0,2,2,0,3,3,1,1,1,0,147,0.00018
KhodNeviss,,,2,0,2,2,0,2,0,0,0,0,147,0.000411
seyyed2009,,,1,0,1,2,0,2,0,0,0,0,147,0.000257
AliAbdolmalek73,,,0,3,3,0,3,3,1,1,1,0,107,0.00018
jad_azad_qom,,,2,0,2,2,0,2,0,0,0,0,107,0.000283
kian_qom,,,1,0,1,1,0,1,0,0,0,0,107,0.000232
lions_iran,,,5,0,5,7,0,7,0,0,0,0,95,0.000559
AliAghaHemati,,,0,1,1,0,1,1,3,0.427273,0.450355,0,95,0.00018
AliAlavii1,,,0,1,1,0,3,3,1,1,1,0,95,0.00018
AliAmir79739248,,,0,2,2,0,3,3,1,1,1,0,95,0.00018
AfsaranIR,,,2,0,2,2,0,2,0,0,0,0,95,0.000334
AliBarb61793120,,,0,1,1,0,1,1,1,1,1,0,95,0.00018
AliBeyki2555,,,0,5,5,0,7,7,1,1,1,0,18,0.00018
Rasputin8569,,,2,0,2,2,0,2,0,0,0,0,18,0.000365
behzad_i,,,1,0,1,1,0,1,0,0,0,0,18,0.000211
maziarajax,,,2,0,2,2,0,2,0,0,0,0,18,0.000365
shahinprs,,,2,0,2,3,0,3,0,0,0,0,18,0.000365
AliDelkhosh,,,0,1,1,0,3,3,1,1,1,0,95,0.00018
AliDibachi,,,0,3,3,0,5,5,1,1,1,0,18,0.00018
BBCArdalan,,,8,0,8,18,0,18,0,0,0,0,18,0.001013
AliDoustkam4,,,0,1,1,0,1,1,1,1,1,0,12,0.00018
AliF99210374,,,0,1,1,0,2,2,1,1,1,0,58,0.00018
baharnargess,,,1,0,1,2,0,2,0,0,0,0,58,0.000334
AliForootan,,,0,1,1,0,1,1,1,1,1,0,59,0.00018
manamoon53,,,1,0,1,1,0,1,0,0,0,0,59,0.000334
AliHeidri,,,0,2,2,0,4,4,1,1,1,0,95,0.00018
ali_mirzaeii,,,1,0,1,1,0,1,0,0,0,0,95,0.000257
AliJaha27230986,,,0,2,2,0,2,2,1,1,1,0,12,0.00018
AliLotfizade,,,0,2,2,0,3,3,1,1,1,0,95,0.00018
SedRonaldo1,,,1,0,1,1,0,1,0,0,0,0,95,0.000257
AliMakoei,,,0,1,1,0,1,1,1,1,1,0,18,0.00018
AliMirmohammadi,,,0,1,1,0,3,3,1,1,1,0,95,0.00018
eshraghyazar,,,4,0,4,12,0,12,0,0,0,0,95,0.000343
AliMoha34158286,,,0,1,1,0,1,1,1,1,1,0,18,0.00018
AliMora42339566,,,1,3,4,1,3,4,2,0.666667,0.75,6,18,0.000257
tanasoli,,,2,0,2,2,0,2,0,0,0,0,18,0.000259
AliMousavian110,,,0,1,1,0,1,1,1,1,1,0,77,0.00018
AliRamss,,,0,2,2,0,2,2,2,0.625,0.7,0,95,0.00018
AliS33996028,,,0,2,2,0,2,2,1,1,1,0,18,0.00018
AliSabb95602255,,,0,1,1,0,1,1,1,1,1,0,18,0.00018
AliSamari_ir,,,0,1,1,0,2,2,1,1,1,0,95,0.00018
AliShadmehr86,,,0,2,2,0,2,2,1,1,1,0,18,0.00018
AliTf17,,,0,1,1,0,3,3,1,1,1,0,18,0.00018
AliYaghobi1,,,0,2,2,0,3,3,1,1,1,0,95,0.00018
Saint_Petrosieh,,,6,0,6,6,0,6,0,0,0,0,95,0.000609
Ali_Ashari_,,,0,1,1,0,1,1,1,1,1,0,77,0.00018
MHozeh,,,6,0,6,6,0,6,0,0,0,0,77,0.00095
Ali_N_J,,,0,2,2,0,6,6,1,1,1,0,95,0.00018
Ali_Rajabi,,,0,2,2,0,3,3,1,1,1,0,77,0.00018
mehrnews_fa,,,2,0,2,2,0,2,0,0,0,0,77,0.000411
Ali_Razavi20,,,0,2,2,0,3,3,1,1,1,0,95,0.00018
ZR50412811,,,2,0,2,2,0,2,0,0,0,0,95,0.000411
Ali_Soltani1,,,0,1,1,0,1,1,1,1,1,0,12,0.00018
Ali__Iran,,,0,1,1,0,2,2,1,1,1,0,18,0.00018
Ali_ghaheri,,,0,1,1,0,1,1,1,1,1,0,18,0.00018
Ali_tkd_h,,,0,1,1,0,4,4,1,1,1,0,18,0.00018
chawshin_83,,,4,0,4,16,0,16,0,0,0,0,18,0.000585
Aliafshari201,,,0,1,1,0,2,2,1,1,1,0,60,0.00018
MRezaMoini,,,1,0,1,2,0,2,0,0,0,0,60,0.000334
Aliakba99476675,,,0,2,2,0,2,2,1,1,1,0,77,0.00018
M46986074,,,1,0,1,1,0,1,0,0,0,0,77,0.000257
Aliali57014080,,,0,1,1,0,1,1,1,1,1,0,95,0.00018
Aliaman31196504,,,0,1,1,0,1,1,2,0.555556,0.6,0,18,0.00018
Aliasad65403475,,,0,1,1,0,1,1,1,1,1,0,95,0.00018
Aliash58546692,,,0,1,1,0,2,2,1,1,1,0,18,0.00018
Aliavazkhah,,,0,1,1,0,2,2,1,1,1,0,61,0.00018
rajanewstwt,,,1,0,1,2,0,2,0,0,0,0,61,0.000334
AlibabaHosain,,,0,1,1,0,1,1,1,1,1,0,12,0.00018
AlibakhshiM,,,0,1,1,0,1,1,1,1,1,0,142,0.00018
Alieh__B,,,0,1,1,0,1,1,1,1,1,0,77,0.00018
AlienationGuy,,,0,1,1,0,1,1,1,1,1,0,18,0.00018
Alienghelabi,,,0,1,1,0,1,1,1,1,1,0,62,0.00018
h_parhizkari,,,1,0,1,1,0,1,0,0,0,0,62,0.000334
Alighamkhar2,,,0,1,1,0,3,3,1,1,1,0,95,0.00018
Alihekmat110,,,0,1,1,0,1,1,1,1,1,0,77,0.00018
Aliireeza,,,0,1,1,0,1,1,1,1,1,0,63,0.00018
miladopiez,,,1,0,1,1,0,1,0,0,0,0,63,0.000334
Alikarimzadeh,,,0,1,1,0,2,2,1,1,1,0,18,0.00018
AlikazemiKazemi,,,0,2,2,0,4,4,1,1,1,0,64,0.00018
javadaghaei2002,,,2,0,2,4,0,4,0,0,0,0,64,0.000411
m_akbarzadeh5,,,1,0,1,2,0,2,0,0,0,0,64,0.000257
AlikhaniMansour,,,0,1,1,0,1,1,1,1,1,0,12,0.00018
Alim224497,,,0,1,1,0,2,2,1,1,1,0,95,0.00018
am_jafarii,,,6,0,6,12,0,12,0,0,0,0,95,0.00076
Alimousaei9,,,0,1,1,0,1,1,1,1,1,0,65,0.00018
Hadi5861,,,2,1,3,2,1,3,0,0,0,0,65,0.000334
Alimozdi_fa,,,0,2,2,0,4,4,1,1,1,0,77,0.00018
qomnews,,,1,0,1,3,0,3,0,0,0,0,77,0.000257
Alinazemi313,,,0,1,1,0,1,1,1,1,1,0,95,0.00018
madam_puaro,,,2,0,2,2,0,2,0,0,0,0,95,0.000335
Alir_Jamali,,,0,1,1,0,2,2,1,1,1,0,77,0.00018
Alirez608,,,0,4,4,0,5,5,2,0.666667,0.75,0,18,0.00018
Alireza05693781,,,1,1,2,1,1,2,2,0.52381,0.545455,0,18,0.000198
BMWROBOT75,,,8,10,18,8,18,26,1,1,1,74.5,18,0.000673
Alireza06970620,,,0,1,1,0,3,3,1,1,1,0,18,0.00018
Alireza44775658,,,0,2,2,0,3,3,1,1,1,0,95,0.00018
AlirezaAbolgha3,,,0,4,4,0,7,7,2,0.833333,0.9,0,77,0.00018
Azadpey1967,,,3,1,4,3,2,5,1,1,1,4,77,0.000301
Lawyer__313,,,1,0,1,2,0,2,0,0,0,0,77,0.000219
Shahrzad1977,,,1,0,1,2,0,2,0,0,0,0,77,0.000219
omid_dana,,,3,0,3,4,0,4,0,0,0,0,77,0.000527
AlirezaAtashak,,,0,1,1,0,3,3,1,1,1,0,18,0.00018
AlirezaAzizmoh1,,,0,1,1,0,1,1,1,1,1,0,77,0.00018
AlirezaDoolabi,,,0,2,2,0,3,3,1,1,1,0,77,0.00018
AlirezaSafaria1,,,0,1,1,0,1,1,1,1,1,0,18,0.00018
AlirezaTaati,,,0,1,1,0,2,2,1,1,1,0,95,0.00018
jaberkhorramnia,,,2,0,2,4,0,4,0,0,0,0,95,0.000373
Alireza_0_0_,,,0,1,1,0,1,1,1,1,1,0,77,0.00018
Alireza_Malekii,,,0,1,1,0,1,1,1,1,1,0,77,0.00018
Alireza__OoO,,,0,1,1,0,1,1,1,1,1,0,66,0.00018
kasraabo,,,1,0,1,1,0,1,0,0,0,0,66,0.000334
Alireza_a238,,,0,1,1,0,1,1,1,1,1,0,95,0.00018
Alireza_mhmdn,,,0,1,1,0,1,1,1,1,1,0,77,0.00018
_30rooss_,,,7,0,7,7,0,7,0,0,0,0,77,0.000863
Alireza_vahedi_,,,0,1,1,0,1,1,1,1,1,0,18,0.00018
Alireza_waffen,,,0,3,3,0,8,8,1,1,1,0,77,0.00018
edalatkhah59,,,3,0,3,4,0,4,0,0,0,0,77,0.00054
m_karimaan,,,1,0,1,2,0,2,0,0,0,0,77,0.000232
Alirezaasmani,,,0,4,4,0,6,6,1,1,1,0,95,0.00018
Alirezalashgar6,,,0,1,1,0,2,2,1,1,1,0,18,0.00018
Alirezamasrour2,,,0,6,6,0,14,14,1,1,1,0,95,0.00018
davoudi135,,,1,0,1,2,0,2,0,0,0,0,95,0.000206
m_rahkozar,,,1,0,1,2,0,2,0,0,0,0,95,0.000206
Alirezawwwwww,,,0,2,2,0,2,2,1,1,1,0,67,0.00018
___charming__,,,1,0,1,1,0,1,0,0,0,0,67,0.000257
mahdixan,,,1,0,1,1,0,1,0,0,0,0,67,0.000257
Alirzabzz,,,0,1,1,0,1,1,1,1,1,0,77,0.00018
Alis85076004,,,0,1,1,0,1,1,2,0.555556,0.6,0,18,0.00018
Alishoonn,,,0,2,2,0,2,2,2,0.6,0.666667,0,18,0.00018
Alitoosi3,,,1,2,3,2,4,6,1,1,1,0,68,0.00018
malih_toosi,,,1,0,1,2,0,2,0,0,0,0,68,0.000257
AliveLaughter,,,0,1,1,0,1,1,1,1,1,0,18,0.00018
AlizadehMostafa,,,0,2,2,0,6,6,1,1,1,0,77,0.00018
sadid59,,,3,0,3,12,0,12,0,0,0,0,77,0.000492
Alliibbddi1357,,,1,1,2,1,1,2,0,0,0,0,69,0.00018
Allseeiingeye,,,0,1,1,0,2,2,1,1,1,0,18,0.00018
AlmasSorkh,,,0,2,2,0,3,3,1,1,1,0,95,0.00018
fmahdipour,,,4,0,4,4,0,4,0,0,0,0,95,0.000498
Alpaccaaa,,,0,1,1,0,1,1,1,1,1,0,77,0.00018
AlphARP2,,,0,2,2,0,5,5,2,0.75,0.833333,0,18,0.00018
Alqods_lana7374,,,0,8,8,0,17,17,1,1,1,0,95,0.00018
MohadeseRezaee,,,1,0,1,3,0,3,0,0,0,0,95,0.0002
Smr_firoozi,,,3,0,3,5,0,5,0,0,0,0,95,0.000207
lasarat1998,,,1,0,1,1,0,1,0,0,0,0,95,0.0002
mrmorteza4,,,4,0,4,8,0,8,0,0,0,0,95,0.000563
pelekanearsh,,,1,0,1,3,0,3,0,0,0,0,95,0.0002
sajjadsalimi70,,,3,0,3,7,0,7,0,0,0,0,95,0.000405
sroozyani,,,1,0,1,1,0,1,0,0,0,0,95,0.0002
Alr677,,,0,1,1,0,1,1,1,1,1,0,77,0.00018
Alvlirali,,,0,1,1,0,2,2,1,1,1,0,95,0.00018
Alya_Ata91,,,0,1,1,0,4,4,1,1,1,0,95,0.00018
Am79651,,,0,1,1,0,1,1,1,1,1,0,18,0.00018
AmIr58760286,,,0,1,1,0,2,2,1,1,1,0,18,0.00018
AmSa2r,,,0,2,2,0,2,2,1,1,1,0,18,0.00018
ftu01,,,2,0,2,2,0,2,0,0,0,0,18,0.000411
Am_esmaeil,,,0,5,5,0,10,10,1,1,1,0,95,0.00018
rachelkoori,,,2,0,2,3,0,3,0,0,0,0,95,0.000212
seyed_abd,,,4,0,4,8,0,8,0,0,0,0,95,0.000249
Amadaghahastam,,,0,2,2,0,2,2,1,1,1,0,95,0.00018
Amanforharddays,,,0,2,2,0,5,5,1,1,1,0,18,0.00018
Amarcopolo1,,,0,2,2,0,3,3,1,1,1,0,18,0.00018
Ameli1508,,,0,1,1,0,1,1,1,1,1,0,77,0.00018
AmeliRika,,,0,1,1,0,1,1,1,1,1,0,77,0.00018
Amene83517444,,,1,2,3,1,2,3,1,1,1,0,95,0.00018
M_Jalili4,,,7,0,7,13,0,13,0,0,0,0,95,0.000676
Amer10015,,,0,1,1,0,2,2,1,1,1,0,70,0.00018
gharibreza1,,,1,0,1,2,0,2,0,0,0,0,70,0.000334
AmetesVatan,,,0,1,1,0,2,2,1,1,1,0,95,0.00018
AmiRoO_,,,0,1,1,0,1,1,1,1,1,0,18,0.00018
AmidDadkhah,,,0,7,7,0,15,15,1,1,1,0,18,0.00018
AliNasri90,,,4,0,4,8,0,8,0,0,0,0,95,0.000433
Janidep14,,,1,0,1,3,0,3,0,0,0,0,18,0.000202
Niiiiiiishhh,,,12,0,12,27,0,27,0,0,0,0,18,0.001035
Amidian_Mostafa,,,0,1,1,0,1,1,1,1,1,0,71,0.00018
abmohajeri,,,1,0,1,1,0,1,0,0,0,0,71,0.000334
Amiiirofficiall,,,0,1,1,0,1,1,1,1,1,0,72,0.00018
omid_3671,,,1,0,1,1,0,1,0,0,0,0,72,0.000334
Amin01631,,,1,42,43,1,77,78,3,0.622951,0.745614,0,95,0.00018
Ali_Akbari_ir,,,2,0,2,2,0,2,0,0,0,0,95,0.000185
Amirkabir1979,,,2,1,3,4,1,5,1,1,1,0,95,0.000185
Enghellab57,,,2,0,2,6,0,6,0,0,0,0,95,0.000206
Motahar_banoo,,,1,0,1,1,0,1,0,0,0,0,95,0.000184
Rezazare63,,,1,0,1,4,0,4,0,0,0,0,95,0.000184
Sabokbaran,,,1,0,1,1,0,1,0,0,0,0,95,0.000184
Zeus98s,,,1,0,1,3,0,3,0,0,0,0,95,0.000184
alimoosavi786,,,3,0,3,3,0,3,0,0,0,0,95,0.000228
az_tabar_yas_1,,,3,0,3,3,0,3,0,0,0,0,95,0.000223
hasan39_mohamad,,,1,0,1,3,0,3,0,0,0,0,95,0.000184
kamrani6014,,,2,0,2,6,0,6,0,0,0,0,95,0.000185
m_ghaedi,,,1,0,1,1,0,1,0,0,0,0,95,0.000184
moh_Evaznia,,,1,0,1,2,0,2,0,0,0,0,95,0.000184
nimohyar,,,1,0,1,3,0,3,0,0,0,0,95,0.000184
pesar_kuhestan,,,6,0,6,6,0,6,0,0,0,0,95,0.000197
s_p_hossini,,,2,0,2,2,0,2,0,0,0,0,95,0.000185
samsam_313,,,1,0,1,1,0,1,0,0,0,0,95,0.000184
sogand213,,,2,0,2,6,0,6,0,0,0,0,95,0.000214
Amin10194596,,,0,1,1,0,2,2,1,1,1,0,18,0.00018
Amin51684661,,,0,1,1,0,4,4,1,1,1,0,73,0.00018
nazmbojnordi,,,2,0,2,8,0,8,0,0,0,0,73,0.000488
AminBabazadeh2,,,0,2,2,0,4,4,1,1,1,0,95,0.00018
AminRaskolnikov,,,0,1,1,0,2,2,1,1,1,0,18,0.00018
Amin_Ghorbanii,,,1,2,3,3,4,7,1,1,1,0,95,0.00018
Aminaa46043558,,,0,1,1,0,1,1,1,1,1,0,18,0.00018
Aminbarati11,,,0,1,1,0,1,1,1,1,1,0,18,0.00018
AminiJamshid,,,0,2,2,0,9,9,1,1,1,0,12,0.00018
begoonaah,,,2,0,2,3,0,3,0,0,0,0,12,0.000296
freedommesenger,,,4,0,4,12,0,12,0,0,0,0,12,0.000501
AminiNajime,,,0,1,1,0,2,2,1,1,1,0,77,0.00018
miraghorbanifar,,,4,0,4,8,0,8,0,0,0,0,77,0.000514
AminiParisa,,,0,1,1,0,1,1,1,1,1,0,12,0.00018
Aminmansouri321,,,0,1,1,0,1,1,1,1,1,0,74,0.00018
parsaei_12,,,1,0,1,1,0,1,0,0,0,0,74,0.000334
Amir17568862,,,0,1,1,0,2,2,1,1,1,0,75,0.00018
haji_mehrpooyan,,,1,0,1,2,0,2,0,0,0,0,75,0.000334
Amir24540173,,,0,2,2,0,2,2,1,1,1,0,18,0.00018
Amir3564,,,0,2,2,0,2,2,2,0.75,0.833333,0,18,0.00018
Amir90897346,,,0,1,1,0,2,2,1,1,1,0,95,0.00018
Mnsour_zartosht,,,3,0,3,6,0,6,0,0,0,0,95,0.000367
AmirAbbasblk,,,0,3,3,0,3,3,1,1,1,0,77,0.00018
behmash,,,3,0,3,3,0,3,0,0,0,0,77,0.000463
AmirAbdolvandi,,,0,1,1,0,1,1,1,1,1,0,77,0.00018
AmirAhmadi45,,,0,1,1,0,2,2,1,1,1,0,76,0.00018
MahshidSotoodeh,,,2,0,2,4,0,4,0,0,0,0,76,0.000488
AmirAli_1996,,,0,1,1,0,1,1,1,1,1,0,18,0.00018
AmirArssalan,,,0,1,1,0,1,1,1,1,1,0,18,0.00018
AmirArya2020,,,0,1,1,0,3,3,1,1,1,0,210,0.00018
TigerPMK,,,2,0,2,9,0,9,0,0,0,0,210,0.000488
AmirBihaya,,,0,5,5,0,9,9,1,1,1,0,77,0.00018
AmirWolv,,,1,0,1,2,0,2,0,0,0,0,77,0.000211
AmirDv92,,,0,2,2,0,4,4,1,1,1,0,77,0.00018
AmirGhorbani69,,,0,3,3,0,6,6,1,1,1,0,95,0.00018
Ehsanrostamian,,,1,0,1,2,0,2,0,0,0,0,95,0.000232
Movahedian69,,,1,0,1,2,0,2,0,0,0,0,95,0.000232
AmirHY994,,,0,1,1,0,2,2,1,1,1,0,77,0.00018
AmirHassanPoya1,,,0,1,1,0,1,1,1,1,1,0,77,0.00018
AmirMorpheus,,,0,1,1,0,1,1,1,1,1,0,18,0.00018
AmirMousavi11,,,0,1,1,0,1,1,1,1,1,0,77,0.00018
AmirNadan,,,0,1,1,0,1,1,1,1,1,0,95,0.00018
AmirPuyaM,,,0,1,1,0,1,1,1,1,1,0,78,0.00018
sharifdavrishe,,,1,0,1,1,0,1,0,0,0,0,78,0.000334
AmirRahiminasab,,,0,1,1,0,2,2,1,1,1,0,77,0.00018
ehsanm92,,,2,0,2,4,0,4,0,0,0,0,77,0.000386
AmirSahbaee,,,0,1,1,0,1,1,1,1,1,0,77,0.00018
AmirSoltanzade2,,,0,1,1,0,2,2,1,1,1,0,77,0.00018
AmirZamini,,,0,4,4,0,4,4,2,0.590909,0.653846,0,18,0.00018
badbadakbaaz,,,1,0,1,1,0,1,0,0,0,0,18,0.000219
Amir_075,,,0,1,1,0,2,2,1,1,1,0,18,0.00018
salmaneshoon,,,3,0,3,6,0,6,0,0,0,0,18,0.000565
Amir_9980,,,0,2,2,0,3,3,1,1,1,0,18,0.00018
Amir_Ejbar,,,0,1,1,0,1,1,1,1,1,0,79,0.00018
M_Asmmm,,,1,0,1,1,0,1,0,0,0,0,79,0.000334
Amiraba94102129,,,2,6,8,10,18,28,1,1,1,10,95,0.000207
tub67,,,5,0,5,7,0,7,0,0,0,0,95,0.000391
Amiralizadeh25,,,0,1,1,0,2,2,1,1,1,0,95,0.00018
Amirbadofficial,,,0,1,1,0,1,1,1,1,1,0,18,0.00018
Amireshounam,,,0,1,1,0,2,2,1,1,1,0,18,0.00018
d_agnostic,,,1,0,1,1,0,1,0,0,0,0,18,0.000356
Amirhooman7,,,0,1,1,0,2,2,1,1,1,0,18,0.00018
Amirhos77264548,,,0,2,2,0,2,2,1,1,1,0,18,0.00018
SiamackShojai,,,5,0,5,5,0,5,0,0,0,0,18,0.000545
sari_kor_leone,,,2,0,2,2,0,2,0,0,0,0,18,0.000411
Amirhossein1_73,,,0,6,6,0,9,9,1,1,1,0,95,0.00018
sajad_parvaneh,,,6,0,6,12,0,12,0,0,0,0,95,0.000399
samirhossein135,,,5,0,5,5,0,5,0,0,0,0,95,0.000295
AmirhosseinMas3,,,0,1,1,0,1,1,1,1,1,0,18,0.00018
SetareSoheil_,,,2,0,2,2,0,2,0,0,0,0,18,0.000373
Amirhossein_sha,,,1,2,3,1,4,5,1,1,1,2,95,0.000257
hajabolghasem,,,2,0,2,4,0,4,0,0,0,0,95,0.000367
Amirhosseinmz2,,,0,2,2,0,2,2,1,1,1,0,18,0.00018
ZfParisa,,,2,0,2,2,0,2,0,0,0,0,18,0.000334
AmirhusseinRuda,,,0,2,2,0,5,5,1,1,1,0,95,0.00018
Amirhussein_313,,,0,2,2,0,4,4,1,1,1,0,95,0.00018
EbrahimShafiey,,,1,0,1,3,0,3,0,0,0,0,95,0.000257
AmiriHamid88,,,0,2,2,0,3,3,1,1,1,0,77,0.00018
t_a1362,,,2,0,2,4,0,4,0,0,0,0,77,0.000334
AmiriHila,,,0,1,1,0,1,1,1,1,1,0,12,0.00018
Amirikhan123,,,0,3,3,0,10,10,1,1,1,0,18,0.00018
Amirilicious1,,,0,5,5,0,7,7,3,0.571429,0.645833,0,18,0.00018
AmirkAmirkk,,,0,1,1,0,1,1,1,1,1,0,95,0.00018
Amirkhaste96,,,0,1,1,0,1,1,1,1,1,0,18,0.00018
AmirmAtefi,,,0,1,1,0,1,1,1,1,1,0,77,0.00018
Amirography,,,0,1,1,0,1,1,1,1,1,0,18,0.00018
Amiroo_69,,,0,1,1,0,1,1,1,1,1,0,18,0.00018
Amiroooo1231,,,0,1,1,0,1,1,1,1,1,0,18,0.00018
Amirpirazad,,,0,1,1,0,1,1,1,1,1,0,77,0.00018
Amirreza1377120,,,0,1,1,0,1,1,1,1,1,0,95,0.00018
AmirrezaAbbas12,,,0,4,4,0,11,11,1,1,1,0,95,0.00018
Alisan313,,,5,0,5,19,0,19,0,0,0,0,95,0.000292
Yaser_slk,,,1,0,1,3,0,3,0,0,0,0,95,0.000219
iravani1999,,,1,0,1,3,0,3,0,0,0,0,95,0.000219
Amirreza_313m,,,0,3,3,0,6,6,1,1,1,0,95,0.00018
dumbledor_ir,,,2,0,2,4,0,4,0,0,0,0,95,0.000235
m_sahandi,,,1,0,1,2,0,2,0,0,0,0,95,0.000232
Amirsad65565520,,,0,1,1,0,1,1,1,1,1,0,158,0.00018
Amirshah_i,,,0,1,1,0,1,1,1,1,1,0,80,0.00018
Shin_err,,,1,0,1,1,0,1,0,0,0,0,80,0.000334
Amirza313,,,0,2,2,0,4,4,1,1,1,0,95,0.00018
Amirzabijan,,,1,5,6,2,7,9,1,1,1,5,18,0.000186
Z0RVAAN,,,3,0,3,3,0,3,0,0,0,0,18,0.000248
Amirzadeh1Reza,,,2,2,4,4,4,8,1,1,1,1,95,0.000257
MiSedehi,,,11,0,11,22,0,22,0,0,0,0,95,0.000886
Honjo__Masamune,,,2,1,3,2,2,4,1,1,1,26,18,0.000231
IRAN_persi,,,2,5,7,6,7,13,3,0.547619,0.601449,76.5,18,0.000198
Leila_Arya,,,4,0,4,4,0,4,0,0,0,0,18,0.000357
Mmn24659294,,,1,0,1,1,0,1,0,0,0,0,18,0.000193
Mohamma58446637,,,3,0,3,4,0,4,0,0,0,0,18,0.000295
eynollah2017,,,2,0,2,2,0,2,0,0,0,0,18,0.000269
ghognous,,,3,0,3,6,0,6,0,0,0,0,18,0.000368
nazanin_ban002,,,3,0,3,8,0,8,0,0,0,0,18,0.000291
Ammarione,,,0,1,1,0,2,2,1,1,1,0,95,0.00018
AmnHsni,,,0,2,2,0,3,3,1,1,1,0,18,0.00018
Amo_Nourooz,,,0,2,2,0,6,6,1,1,1,0,18,0.00018
AmooRasoul,,,0,1,1,0,1,1,1,1,1,0,77,0.00018
Amoo_Sibiloo,,,0,4,4,0,6,6,2,0.833333,0.9,0,18,0.00018
Amordadan,,,0,4,4,0,6,6,1,1,1,0,18,0.00018
IamZeus6,,,2,0,2,6,0,6,0,0,0,0,18,0.000257
AmouzadehReza,,,0,1,1,0,1,1,1,1,1,0,18,0.00018
Amoxi500,,,0,4,4,0,6,6,2,0.583333,0.642857,0,18,0.00018
Amupoor_128,,,0,3,3,0,3,3,1,1,1,0,95,0.00018
e_s_bagheri,,,2,0,2,2,0,2,0,0,0,0,95,0.00025
nilo34027606,,,5,0,5,8,0,8,0,0,0,0,95,0.000464
Ana_manatina,,,2,5,7,6,11,17,2,0.857143,0.916667,6,77,0.00029
HabibNajar10,,,2,6,8,5,11,16,2,0.857143,0.916667,0,77,0.00023
mehdi_moharrami,,,2,0,2,2,0,2,0,0,0,0,77,0.000263
mehdighavidelll,,,3,0,3,9,0,9,0,0,0,0,77,0.000285
Anahita84083716,,,0,14,14,0,24,24,5,0.391813,0.495522,0,18,0.00018
EstebdadSetiz,,,2,0,2,2,0,2,0,0,0,0,18,0.000197
dokhtare__atash,,,6,0,6,6,0,6,0,0,0,0,18,0.000245
janati100,,,4,0,4,4,0,4,0,0,0,0,18,0.000316
samuraiassass,,,1,0,1,1,0,1,0,0,0,0,18,0.000191
AnahitaDasht,,,0,4,4,0,11,11,2,0.833333,0.9,0,18,0.00018
Anastazzzzzia,,,0,1,1,0,1,1,1,1,1,0,18,0.00018
Andrew31838334,,,0,4,4,0,8,8,1,1,1,0,18,0.00018
StMarti71671310,,,1,0,1,2,0,2,0,0,0,0,18,0.000219
Aneetaaaaaa,,,0,8,8,0,13,13,1,1,1,0,18,0.00018
FarPRPzad,,,1,0,1,1,0,1,0,0,0,0,18,0.0002
behzadmehrani,,,4,0,4,4,0,4,0,0,0,0,18,0.000431
divoda327745181,,,1,0,1,3,0,3,0,0,0,0,18,0.0002
mashckuk,,,2,0,2,3,0,3,0,0,0,0,18,0.000354
wilsonroc4,,,4,0,4,7,0,7,0,0,0,0,18,0.000397
Ani01481639,,,0,5,5,0,6,6,1,1,1,0,18,0.00018
IranAza01253627,,,1,4,5,1,8,9,1,1,1,0,18,0.000211
MalekiMani,,,2,0,2,2,0,2,0,0,0,0,18,0.000256
AnmarEied,,,0,1,1,0,2,2,1,1,1,0,81,0.00018
LikeTheSky0,,,1,0,1,2,0,2,0,0,0,0,81,0.000334
AnneliesMaria,,,0,8,8,0,11,11,3,0.62069,0.712963,0,18,0.00018
NavidEftekhar1,,,2,0,2,2,0,2,0,0,0,0,18,0.000212
ramhfreedom,,,2,0,2,2,0,2,0,0,0,0,18,0.000251
Ansar7064,,,0,22,22,0,43,43,3,0.59596,0.677966,0,95,0.00018
Ali_mastali2,,,3,0,3,6,0,6,0,0,0,0,95,0.000198
Fatemeh5874,,,1,21,22,2,46,48,2,0.888889,0.9375,21,95,0.000187
Gamandeh,,,3,4,7,10,11,21,1,1,1,5,95,0.000188
Hasher_313,,,2,0,2,4,0,4,0,0,0,0,95,0.000226
JingilKhan111,,,1,15,16,2,41,43,1,1,1,15,95,0.000187
Mhdinemati,,,3,0,3,6,0,6,0,0,0,0,95,0.000221
Shamime_Sobh,,,3,0,3,6,0,6,0,0,0,0,95,0.000367
arose_sadat,,,1,0,1,2,0,2,0,0,0,0,95,0.000187
kourosh_q,,,1,0,1,2,0,2,0,0,0,0,95,0.000187
m_Jamali_t,,,2,0,2,4,0,4,0,0,0,0,95,0.000203
moravah,,,1,0,1,3,0,3,0,0,0,0,95,0.000187
mrbehtouei,,,4,0,4,4,0,4,0,0,0,0,95,0.000251
s_izadgashb,,,2,0,2,4,0,4,0,0,0,0,95,0.000228
smjjjmdh,,,1,0,1,1,0,1,0,0,0,0,95,0.000187
somayye16,,,1,0,1,1,0,1,0,0,0,0,95,0.000187
Anshan20012653,,,0,1,1,0,1,1,2,0.666667,0.75,0,77,0.00018
ArmaneBahari,,,1,1,2,1,2,3,1,1,1,1,77,0.000334
AntiRomantiG,,,0,1,1,0,1,1,1,1,1,0,18,0.00018
Anti_Akhoond,,,0,4,4,0,4,4,1,1,1,0,18,0.00018
Anti_ZZZZ,,,0,1,1,0,1,1,1,1,1,0,77,0.00018
Anti_jomhori,,,0,1,1,0,1,1,2,0.555556,0.6,0,18,0.00018
Anvior_Halvorsn,,,0,1,1,0,1,1,1,1,1,0,18,0.00018
AnzaliMojtaba,,,0,1,1,0,5,5,1,1,1,0,95,0.00018
Morteza_Anzali,,,5,0,5,23,0,23,0,0,0,0,95,0.000566
AnzaliSangachin,,,0,6,6,0,12,12,1,1,1,0,95,0.00018
Anzali_5676,,,0,1,1,0,5,5,1,1,1,0,95,0.00018
Anzali_Morteza,,,0,3,3,0,8,8,1,1,1,0,95,0.00018
sad_sotoodeh,,,6,0,6,12,0,12,0,0,0,0,95,0.000623
Ap50374595,,,0,4,4,0,6,6,1,1,1,0,18,0.00018
gandimahatma190,,,1,0,1,3,0,3,0,0,0,0,18,0.000219
syedmahomadfhfr,,,2,0,2,2,0,2,0,0,0,0,18,0.000257
ApoShahoo,,,0,1,1,0,1,1,1,1,1,0,18,0.00018
AqZabun,,,1,1,2,1,2,3,1,1,1,1,95,0.000334
SocialTelescop,,,5,0,5,10,0,10,0,0,0,0,95,0.001005
AqaMohammadKhan,,,0,1,1,0,2,2,1,1,1,0,77,0.00018
AqaSheys,,,0,2,2,0,4,4,1,1,1,0,95,0.00018
Aqaye_khass1,,,0,1,1,0,1,1,1,1,1,0,18,0.00018
ArAshAn66,,,0,1,1,0,2,2,1,1,1,0,18,0.00018
Ar__Ne,,,0,2,2,0,2,2,1,1,1,0,18,0.00018
Ara79732532,,,0,6,6,0,10,10,1,1,1,0,18,0.00018
Maziyarr2,,,1,0,1,2,0,2,0,0,0,0,18,0.000206
PejmanA3,,,2,0,2,5,0,5,0,0,0,0,18,0.000211
Ara9h,,,0,1,1,0,1,1,1,1,1,0,77,0.00018
ArabiNeda,,,0,1,1,0,1,1,1,1,1,0,77,0.00018
Aragon33Aragon,,,0,1,1,0,1,1,1,1,1,0,18,0.00018
Aragorn2k16,,,0,1,1,0,2,2,1,1,1,0,77,0.00018
Aram7,,,0,2,2,0,4,4,2,0.75,0.833333,0,18,0.00018
AramParviz,,,0,2,2,0,4,4,1,1,1,0,18,0.00018
Arash12mo21,,,0,1,1,0,1,1,1,1,1,0,82,0.00018
asadolahmossana,,,1,0,1,1,0,1,0,0,0,0,82,0.000334
Arash25569858,,,0,3,3,0,3,3,1,1,1,0,18,0.00018
Arash55730019,,,0,1,1,0,3,3,1,1,1,0,18,0.00018
Arash70091063,,,0,1,1,0,6,6,1,1,1,0,18,0.00018
Arash72872909,,,0,6,6,0,9,9,2,0.875,0.928571,0,18,0.00018
dodoozeh,,,2,0,2,2,0,2,0,0,0,0,18,0.000228
guy__fawkess,,,1,0,1,3,0,3,0,0,0,0,18,0.000206
Arash797979,,,0,1,1,0,2,2,1,1,1,0,18,0.00018
ArashBahrekaze3,,,0,1,1,0,1,1,1,1,1,0,142,0.00018
ArashJahangardl,,,0,1,1,0,1,1,1,1,1,0,18,0.00018
ArashKa45412967,,,0,2,2,0,4,4,1,1,1,0,18,0.00018
ArashMAria,,,0,1,1,0,1,1,1,1,1,0,18,0.00018
ArashNamy,,,0,1,1,0,1,1,1,1,1,0,95,0.00018
ArashStark,,,0,2,2,0,3,3,1,1,1,0,18,0.00018
Arash_21_21,,,0,7,7,0,13,13,6,0.252918,0.338974,0,18,0.00018
black_cat_e_o,,,2,0,2,2,0,2,0,0,0,0,18,0.000356
nbcfhjknddhjknb,,,7,0,7,8,0,8,0,0,0,0,18,0.000532
Arash_Maryami,,,0,1,1,0,1,1,1,1,1,0,12,0.00018
Arash_ka1361,,,0,1,1,0,7,7,1,1,1,0,18,0.00018
Arash_m96,,,0,3,3,0,6,6,1,1,1,0,18,0.00018
Arash_micro,,,0,1,1,0,1,1,2,0.555556,0.6,0,18,0.00018
Arashkalak,,,0,5,5,0,8,8,2,0.777778,0.857143,0,18,0.00018
Babakkhoram4,,,2,0,2,4,0,4,0,0,0,0,18,0.000238
Sam_IR_Freedom,,,3,0,3,6,0,6,0,0,0,0,18,0.000255
Arazmt1377,,,0,1,1,0,1,1,1,1,1,0,83,0.00018
radikalap,,,1,0,1,1,0,1,0,0,0,0,83,0.000334
ArbabeVadeha,,,0,1,1,0,3,3,1,1,1,0,84,0.00018
tayyebi1989,,,1,0,1,3,0,3,0,0,0,0,84,0.000334
Arcur7,,,0,1,1,0,2,2,1,1,1,0,85,0.00018
sheykhena,,,3,0,3,5,0,5,0,0,0,0,85,0.000642
Ardalan33639058,,,0,1,1,0,1,1,1,1,1,0,18,0.00018
Ardavanam,,,0,1,1,0,1,1,1,1,1,0,18,0.00018
ArdeshirBabaka3,,,0,5,5,0,10,10,1,1,1,0,18,0.00018
Roshanaeii,,,3,0,3,3,0,3,0,0,0,0,18,0.000282
mohamma90316371,,,2,0,2,2,0,2,0,0,0,0,18,0.000228
ArdsisSasani,,,0,1,1,0,1,1,1,1,1,0,18,0.00018
ArefMontazeri,,,0,1,1,0,1,1,1,1,1,0,18,0.00018
ArezooA_,,,0,1,1,0,1,1,2,0.666667,0.75,0,18,0.00018
EyL0t,,,1,1,2,1,1,2,1,1,1,1,18,0.000334
Arezootoon,,,0,1,1,0,1,1,1,1,1,0,18,0.00018
ArghavanBaharii,,,0,1,1,0,1,1,1,1,1,0,86,0.00018
inazkam,,,1,0,1,1,0,1,0,0,0,0,86,0.000334
Arghavaniii_,,,0,2,2,0,3,3,1,1,1,0,87,0.00018
18ParaMoon,,,1,0,1,1,0,1,0,0,0,0,87,0.000257
ArminNavabi,,,5,1,6,10,2,12,0,0,0,0,87,0.000719
ArgiopeSpp,,,0,1,1,0,2,2,1,1,1,0,88,0.00018
Alihasani1370,,,1,0,1,2,0,2,0,0,0,0,88,0.000334
Aria2016S,,,0,1,1,0,1,1,1,1,1,0,18,0.00018
Aria2049,,,0,1,1,0,2,2,1,1,1,0,18,0.00018
Aria_ArefAdib,,,0,2,2,0,3,3,2,0.75,0.833333,0,18,0.00018
Ariamaneshian,,,0,2,2,0,2,2,1,1,1,0,18,0.00018
manolios80,,,1,0,1,1,0,1,0,0,0,0,18,0.000257
Ariamehr25,,,0,3,3,0,5,5,1,1,1,0,18,0.00018
Arian21165018,,,0,1,1,0,1,1,1,1,1,0,18,0.00018
Ariya77311,,,0,1,1,0,2,2,1,1,1,0,77,0.00018
hamedrasoli0,,,4,0,4,8,0,8,0,0,0,0,77,0.000681
AriyayiHatam,,,0,3,3,0,4,4,2,0.8,0.875,0,18,0.00018
rah73v0m,,,5,0,5,5,0,5,0,0,0,0,28,0.000745
Arkadybehzad,,,0,1,1,0,1,1,1,1,1,0,89,0.00018
Fo_Ramin,,,1,0,1,1,0,1,0,0,0,0,89,0.000334
Arman19840705,,,0,2,2,0,2,2,1,1,1,0,18,0.00018
ArmanAkbari20,,,0,1,1,0,1,1,1,1,1,0,90,0.00018
Sana_Restarti,,,1,0,1,1,0,1,0,0,0,0,90,0.000334
ArmanIraniFa,,,0,1,1,0,2,2,1,1,1,0,91,0.00018
R_Shahbazii,,,1,0,1,2,0,2,0,0,0,0,91,0.000334
Arman_0000,,,0,1,1,0,1,1,1,1,1,0,18,0.00018
ArmandoArman8,,,0,1,1,0,1,1,1,1,1,0,18,0.00018
ArminAhmad9,,,0,1,1,0,1,1,1,1,1,0,12,0.00018
ArminMaurice,,,0,2,2,0,5,5,1,1,1,0,18,0.00018
hashemasa,,,3,0,3,9,0,9,0,0,0,0,18,0.000339
Arsalannp,,,0,1,1,0,1,1,1,1,1,0,18,0.00018
Arsames_,,,0,1,1,0,1,1,1,1,1,0,18,0.00018
Arshakarakilian,,,0,5,5,0,5,5,2,0.666667,0.75,0,18,0.00018
ElTigre_mas,,,2,4,6,2,5,7,1,1,1,16,18,0.000242
Jean_paul1987,,,2,1,3,2,1,3,1,1,1,2,18,0.000242
Arshida_bab,,,0,1,1,0,1,1,1,1,1,0,18,0.00018
Arshiya96211428,,,0,1,1,0,4,4,1,1,1,0,95,0.00018
Arshya_SH_M,,,0,1,1,0,1,1,1,1,1,0,18,0.00018
Arsis86,,,0,12,12,0,17,17,2,0.928571,0.961538,0,18,0.00018
ArtanAriafar,,,0,2,2,0,2,2,1,1,1,0,18,0.00018
scorpiiion_90,,,1,0,1,1,0,1,0,0,0,0,18,0.000257
Artemis_Iran,,,0,2,2,0,4,4,2,0.75,0.833333,0,18,0.00018
Artemisbanooo,,,0,2,2,0,2,2,2,0.666667,0.75,0,18,0.00018
ArteshBodd,,,0,4,4,0,9,9,2,0.833333,0.9,0,12,0.00018
sirmalcomx,,,1,0,1,1,0,1,0,0,0,0,12,0.000219
Artmisfromiran,,,0,1,1,0,1,1,1,1,1,0,92,0.00018
Vacant_desert,,,1,0,1,1,0,1,0,0,0,0,92,0.000334
Artor2270,,,0,9,9,0,12,12,5,0.371622,0.475152,0,18,0.00018
Katenaaaaas,,,1,0,1,1,0,1,0,0,0,0,18,0.000198
Patriot31334286,,,1,0,1,1,0,1,0,0,0,0,18,0.000198
Arvin_C01,,,0,1,1,0,1,1,1,1,1,0,77,0.00018
Arya94294115,,,0,1,1,0,2,2,1,1,1,0,95,0.00018
HabibJazani,,,2,0,2,4,0,4,0,0,0,0,95,0.00036
AryaMeh14852591,,,0,5,5,0,8,8,1,1,1,0,18,0.00018
naz_tosan,,,1,0,1,1,0,1,0,0,0,0,18,0.000211
roustaie1,,,1,0,1,1,0,1,0,0,0,0,18,0.000211
AryaNik2020,,,0,1,1,0,1,1,1,1,1,0,18,0.00018
AryaRadfar,,,0,2,2,0,2,2,1,1,1,0,18,0.00018
akuramo5,,,1,0,1,1,0,1,0,0,0,0,18,0.000257
AryaZaree,,,0,1,1,0,4,4,1,1,1,0,18,0.00018
Arya_iranii,,,3,6,9,3,6,9,1,1,1,17.5,18,0.000403
Aryaa_Mehr,,,0,1,1,0,1,1,2,0.6,0.666667,0,18,0.00018
BBitaIrani,,,2,2,4,3,4,7,1,1,1,4,18,0.000373
AryanJahan,,,0,1,1,0,1,1,1,1,1,0,77,0.00018
Aryana25096967,,,0,1,1,0,1,1,1,1,1,0,93,0.00018
Undorsa,,,1,0,1,1,0,1,0,0,0,0,93,0.000334
Arzo13053598,,,0,1,1,0,2,2,1,1,1,0,18,0.00018
As21038796,,,0,1,1,0,1,1,1,1,1,0,18,0.00018
YaAlimola_50002,,,2,0,2,2,0,2,0,0,0,0,95,0.000241
khanoomak,,,2,0,2,4,0,4,0,0,0,0,95,0.000304
Asad53Asad53,,,0,2,2,0,2,2,1,1,1,0,18,0.00018
shireenbayat,,,1,0,1,1,0,1,0,0,0,0,18,0.000257
AsadabadEsfanda,,,0,2,2,0,4,4,1,1,1,0,95,0.00018
Asal_84,,,0,3,3,0,3,3,3,0.538462,0.595238,0,18,0.00018
Asal_d1382,,,0,1,1,0,1,1,1,1,1,0,18,0.00018
AsedMomed,,,0,1,1,0,2,2,1,1,1,0,95,0.00018
mohsenmortazavi,,,3,0,3,6,0,6,0,0,0,0,95,0.000491
AsemanMehrabani,,,0,1,1,0,1,1,1,1,1,0,77,0.00018
ZohoorNazdikAst,,,2,0,2,3,0,3,0,0,0,0,95,0.000209
d_hamsadeh,,,2,0,2,9,0,9,0,0,0,0,95,0.000209
AsemaniTabassom,,,0,1,1,0,1,1,1,1,1,0,18,0.00018
Saam24375122,,,1,0,1,1,0,1,0,0,0,0,18,0.000224
armanibash,,,1,0,1,2,0,2,0,0,0,0,18,0.000224
mim_shirdel,,,1,0,1,2,0,2,0,0,0,0,18,0.000224
Ashahin06,,,0,2,2,0,2,2,1,1,1,0,18,0.00018
BARANDAAZ_NEWS,,,3,0,3,3,0,3,0,0,0,0,18,0.00035
Hale43789255,,,6,4,10,18,7,25,1,1,1,9.666667,95,0.000264
delaramkhoda2,,,4,0,4,10,0,10,0,0,0,0,95,0.000237
eshgehheidar,,,6,0,6,8,0,8,0,0,0,0,95,0.000296
gomnam66415071,,,2,0,2,4,0,4,0,0,0,0,95,0.000217
hura_313,,,4,0,4,12,0,12,0,0,0,0,95,0.000291
javad_najjarpor,,,4,0,4,4,0,4,0,0,0,0,95,0.000291
AshenaBaran,,,0,3,3,0,4,4,1,1,1,0,18,0.00018
TheGreatDariush,,,2,0,2,2,0,2,0,0,0,0,18,0.000237
AshkanKamran,,,0,1,1,0,1,1,1,1,1,0,12,0.00018
AshkanSanami,,,0,1,1,0,1,1,2,0.555556,0.6,0,18,0.00018
AshkaniFarzad,,,0,4,4,0,9,9,1,1,1,0,18,0.00018
Ashkanitto,,,0,2,2,0,3,3,1,1,1,0,18,0.00018
Ashkanium,,,0,1,1,0,1,1,1,1,1,0,94,0.00018
behzad_bh,,,1,0,1,1,0,1,0,0,0,0,94,0.000334
AshoftehAfraz,,,0,1,1,0,1,1,1,1,1,0,12,0.00018
Ashrafi4ever,,,0,1,1,0,1,1,1,1,1,0,12,0.00018
AsiyehAsi,,,0,1,1,0,4,4,1,1,1,0,18,0.00018
Asj_99,,,0,1,1,0,2,2,1,1,1,0,18,0.00018
AspiranDudkar,,,0,1,1,0,2,2,1,1,1,0,18,0.00018
Assana71761215,,,0,1,1,0,2,2,1,1,1,0,18,0.00018
Astare19,,,0,192,192,0,349,349,4,0.712,0.840512,0,95,0.00018
133_mojtaba,,,3,0,3,6,0,6,0,0,0,0,95,0.000189
8n7z8BJTS5GIelu,,,1,0,1,2,0,2,0,0,0,0,95,0.000181
A_S_KH_,,,2,0,2,2,0,2,0,0,0,0,95,0.000184
Ahmadalahwazi73,,,2,0,2,2,0,2,0,0,0,0,95,0.000187
AhmedyHussenDos,,,1,0,1,3,0,3,0,0,0,0,95,0.000181
Akhodadadi2,,,1,0,1,1,0,1,0,0,0,0,95,0.000181
Ali53212620,,,1,0,1,1,0,1,0,0,0,0,95,0.000181
Ali_khorshidi58,,,1,0,1,2,0,2,0,0,0,0,95,0.000181
Amaniroya_ir,,,1,0,1,1,0,1,0,0,0,0,95,0.000181
Amin_drrj,,,1,0,1,1,0,1,0,0,0,0,95,0.000181
AmirJafri32500,,,1,0,1,1,0,1,0,0,0,0,95,0.000181
AmirMoh94798209,,,1,0,1,1,0,1,0,0,0,0,95,0.000181
AtefehGh7,,,1,0,1,1,0,1,0,0,0,0,95,0.000181
AvAbolfazl,,,2,0,2,3,0,3,0,0,0,0,95,0.000335
BamatyMaryam,,,1,1,2,1,1,2,1,1,1,1,95,0.000181
Bbb73113961,,,1,2,3,1,2,3,1,1,1,2,95,0.000181
C3vJQBWlA4yq0m5,,,1,0,1,2,0,2,0,0,0,0,95,0.000181
EhsanNooredin,,,2,0,2,2,0,2,0,0,0,0,95,0.000187
F313N,,,2,0,2,6,0,6,0,0,0,0,95,0.000192
Gomnam_98,,,1,6,7,3,13,16,2,0.875,0.928571,5,95,0.000181
HOSNZHRA,,,1,32,33,1,53,54,3,0.584507,0.676707,51,95,0.000181
Helmaahmadiii,,,1,0,1,1,0,1,0,0,0,0,95,0.000181
MOSAYEBSOLTANY,,,1,0,1,1,0,1,0,0,0,0,95,0.000181
M_110m_,,,1,0,1,3,0,3,0,0,0,0,95,0.000181
M_m_binab,,,2,0,2,2,0,2,0,0,0,0,95,0.000184
MaTekrar,,,1,0,1,1,0,1,0,0,0,0,95,0.000181
Masoodsafa313,,,2,0,2,3,0,3,0,0,0,0,95,0.000185
Mm114114,,,1,0,1,1,0,1,0,0,0,0,95,0.000181
Mmahdiyazdani1,,,1,0,1,2,0,2,0,0,0,0,95,0.000181
Mohamad73146268,,,1,0,1,3,0,3,0,0,0,0,95,0.000181
Mohamadabdolla8,,,1,0,1,1,0,1,0,0,0,0,95,0.000181
Mohamma17247009,,,1,0,1,1,0,1,0,0,0,0,95,0.000181
Mohamma62617194,,,1,0,1,3,0,3,0,0,0,0,95,0.000181
MohammadAl73,,,1,0,1,1,0,1,0,0,0,0,95,0.000181
MohammadMolaeik,,,1,0,1,2,0,2,0,0,0,0,95,0.000181
Mohsen_Rahbar,,,1,0,1,2,0,2,0,0,0,0,95,0.000181
MrRahbari,,,1,0,1,3,0,3,0,0,0,0,95,0.000181
Nafise8131,,,3,0,3,3,0,3,0,0,0,0,95,0.000239
Parsa_Yari,,,5,0,5,6,0,6,0,0,0,0,95,0.000193
QolamiN,,,1,0,1,2,0,2,0,0,0,0,95,0.000181
RVelayat,,,1,0,1,3,0,3,0,0,0,0,95,0.000181
RezaGhorbani110,,,1,0,1,2,0,2,0,0,0,0,95,0.000181
Rezaz7197,,,1,0,1,2,0,2,0,0,0,0,95,0.000181
SAmirMAR14,,,1,0,1,2,0,2,0,0,0,0,95,0.000181
Sadat28573249,,,2,0,2,4,0,4,0,0,0,0,95,0.000182
Sadegh_Asadi66,,,1,0,1,1,0,1,0,0,0,0,95,0.000181
SaeedHaghighi3,,,1,0,1,1,0,1,0,0,0,0,95,0.000181
Saeid_bakhshi27,,,2,0,2,6,0,6,0,0,0,0,95,0.000191
Sarbazevelayate,,,1,0,1,1,0,1,0,0,0,0,95,0.000181
Spourabbas1,,,1,0,1,1,0,1,0,0,0,0,95,0.000181
TAHA29535465,,,1,0,1,1,0,1,0,0,0,0,95,0.000181
TShayeste,,,1,0,1,3,0,3,0,0,0,0,95,0.000181
TehranBoyX,,,1,0,1,1,0,1,0,0,0,0,95,0.000181
Twiti_boy,,,2,0,2,4,0,4,0,0,0,0,95,0.000335
ULop8Q96PkwNXvU,,,1,0,1,2,0,2,0,0,0,0,95,0.000181
Vahidsiavashi1,,,1,0,1,1,0,1,0,0,0,0,95,0.000181
Yo_khalili,,,1,0,1,1,0,1,0,0,0,0,95,0.000181
_narimani,,,1,0,1,1,0,1,0,0,0,0,95,0.000181
alizare313,,,1,0,1,1,0,1,0,0,0,0,95,0.000181
anarezarrin,,,4,0,4,7,0,7,0,0,0,0,95,0.000216
anti_yahud,,,1,0,1,1,0,1,0,0,0,0,95,0.000181
aramesh_68,,,2,0,2,2,0,2,0,0,0,0,95,0.000335
arman_talayi,,,1,0,1,1,0,1,0,0,0,0,95,0.000181
baran_wmr,,,1,0,1,1,0,1,0,0,0,0,95,0.000181
bolaghiruby,,,4,0,4,8,0,8,0,0,0,0,95,0.000392
daftaremashgh,,,1,0,1,2,0,2,0,0,0,0,95,0.000181
daj_erfan,,,1,0,1,1,0,1,0,0,0,0,95,0.000181
fahimeh_abasi,,,1,0,1,2,0,2,0,0,0,0,95,0.000181
firozfirozehei,,,2,0,2,3,0,3,0,0,0,0,95,0.000182
hadis_gholamiy,,,1,0,1,1,0,1,0,0,0,0,95,0.000181
hamid_khoddani,,,1,0,1,1,0,1,0,0,0,0,95,0.000181
hossein77_,,,3,0,3,3,0,3,0,0,0,0,95,0.000412
iran_eslamii,,,3,0,3,6,0,6,0,0,0,0,95,0.000185
jafari_ali31,,,1,0,1,1,0,1,0,0,0,0,95,0.000181
jam_alisobhani,,,1,0,1,3,0,3,0,0,0,0,95,0.000181
jangsard,,,1,0,1,1,0,1,0,0,0,0,95,0.000181
javadnajafi_,,,1,0,1,3,0,3,0,0,0,0,95,0.000181
kakoopino,,,1,0,1,1,0,1,0,0,0,0,95,0.000181
kamranAbulfazl,,,1,0,1,3,0,3,0,0,0,0,95,0.000181
khakriz24,,,1,0,1,1,0,1,0,0,0,0,95,0.000181
khanom_chadori7,,,2,0,2,7,0,7,0,0,0,0,95,0.000192
kiani_arash99,,,1,0,1,1,0,1,0,0,0,0,95,0.000181
larri515,,,1,0,1,1,0,1,0,0,0,0,95,0.000181
m_noroozpoor,,,6,0,6,18,0,18,0,0,0,0,95,0.000216
mahdi_takallou,,,1,0,1,1,0,1,0,0,0,0,95,0.000181
mahdiadrkni313,,,1,0,1,1,0,1,0,0,0,0,95,0.000181
mahjor6,,,1,0,1,3,0,3,0,0,0,0,95,0.000181
mameshi77,,,1,0,1,1,0,1,0,0,0,0,95,0.000181
mcmir,,,1,0,1,1,0,1,0,0,0,0,95,0.000181
meysamabdolahy,,,3,0,3,11,0,11,0,0,0,0,95,0.000225
mina_hanem,,,2,0,2,2,0,2,0,0,0,0,95,0.000184
miremadgh,,,1,0,1,3,0,3,0,0,0,0,95,0.000181
miss_sanam72,,,1,0,1,1,0,1,0,0,0,0,95,0.000181
moein_1571,,,1,0,1,3,0,3,0,0,0,0,95,0.000181
musQeMHyXIBmpIU,,,1,0,1,1,0,1,0,0,0,0,95,0.000181
naghiMamolii,,,5,0,5,5,0,5,0,0,0,0,95,0.000406
nrz_ahvaz,,,3,0,3,12,0,12,0,0,0,0,95,0.000223
omidhajbabaie,,,1,0,1,3,0,3,0,0,0,0,95,0.000181
pedramshaer1,,,2,0,2,2,0,2,0,0,0,0,95,0.000186
pirani_f,,,1,0,1,1,0,1,0,0,0,0,95,0.000181
prshanhidrolik1,,,1,0,1,1,0,1,0,0,0,0,95,0.000181
radmaneslami,,,1,0,1,1,0,1,0,0,0,0,95,0.000181
rezaseyfi610,,,1,0,1,1,0,1,0,0,0,0,95,0.000181
rezology11,,,1,0,1,3,0,3,0,0,0,0,95,0.000181
rezvin9,,,1,0,1,1,0,1,0,0,0,0,95,0.000181
roohollah888,,,2,0,2,2,0,2,0,0,0,0,95,0.000184
sabzikhordan,,,1,0,1,1,0,1,0,0,0,0,95,0.000181
sadegh_r_m,,,1,0,1,1,0,1,0,0,0,0,95,0.000181
saeid_afsari,,,1,0,1,1,0,1,0,0,0,0,95,0.000181
samand2594,,,1,0,1,1,0,1,0,0,0,0,95,0.000181
samira2983,,,4,0,4,4,0,4,0,0,0,0,95,0.000231
sanaei_esf,,,2,0,2,2,0,2,0,0,0,0,95,0.000198
sanaz29746304,,,1,0,1,1,0,1,0,0,0,0,95,0.000181
saraeskandarii,,,1,0,1,2,0,2,0,0,0,0,95,0.000181
setak1992,,,1,0,1,3,0,3,0,0,0,0,95,0.000181
seyyed07166036,,,1,0,1,1,0,1,0,0,0,0,95,0.000181
sh00866n,,,1,0,1,1,0,1,0,0,0,0,95,0.000181
shahadat_313_00,,,1,0,1,3,0,3,0,0,0,0,95,0.000181
shazdehh67,,,1,0,1,1,0,1,0,0,0,0,95,0.000181
simindokhtiran,,,1,0,1,1,0,1,0,0,0,0,95,0.000181
sohrabfarsi,,,3,0,3,4,0,4,0,0,0,0,95,0.0002
takfiry,,,5,0,5,5,0,5,0,0,0,0,95,0.00023
uk_iri,,,1,0,1,1,0,1,0,0,0,0,95,0.000181
vsadri7,,,1,0,1,1,0,1,0,0,0,0,95,0.000181
yVA4ATUfdofr2xS,,,4,0,4,4,0,4,0,0,0,0,95,0.000206
yekimesletodige,,,2,0,2,3,0,3,0,0,0,0,95,0.000186
zeinabrafia,,,1,0,1,3,0,3,0,0,0,0,95,0.000181
zoolbia_bamia,,,1,0,1,5,0,5,0,0,0,0,95,0.000181
Atavolla,,,0,1,1,0,2,2,1,1,1,0,18,0.00018
Ateke_banoo,,,0,1,1,0,1,1,1,1,1,0,5,0.00018
Atena2358,,,0,1,1,0,2,2,1,1,1,0,95,0.00018
AtenaFaghani,,,0,1,1,0,1,1,1,1,1,0,95,0.00018
AtharHrm,,,0,1,1,0,2,2,1,1,1,0,95,0.00018
AtheistBalooch,,,0,1,1,0,2,2,1,1,1,0,18,0.00018
AtheistDanyal,,,0,1,1,0,4,4,1,1,1,0,18,0.00018
Athena_988,,,0,1,1,0,1,1,1,1,1,0,18,0.00018
Atieh92,,,0,1,1,0,1,1,1,1,1,0,18,0.00018
Atila91603151,,,0,1,1,0,1,1,3,0.5,0.527778,0,18,0.00018
Atiyeh_hemmati,,,0,1,1,0,1,1,1,1,1,0,77,0.00018
AtkinsKhan,,,0,4,4,0,4,4,1,1,1,0,77,0.00018
SinaTweeted,,,1,0,1,1,0,1,0,0,0,0,77,0.000219
naader___,,,4,0,4,4,0,4,0,0,0,0,77,0.000681
Atom_of_Eden,,,0,1,1,0,1,1,1,1,1,0,77,0.00018
Atre_Yaas2,,,5,4,9,9,9,18,1,1,1,20,77,0.000377
Atre_Yaas313,,,0,1,1,0,4,4,2,0.571429,0.625,0,77,0.00018
AttaAlavi,,,0,1,1,0,1,1,1,1,1,0,12,0.00018
Attabak3,,,0,1,1,0,3,3,1,1,1,0,95,0.00018
AugustineSani,,,0,1,1,0,1,1,1,1,1,0,77,0.00018
AugustvonHayek,,,0,1,1,0,2,2,1,1,1,0,18,0.00018
AurangzebAQ,,,0,1,1,0,1,1,1,1,1,0,158,0.00018
Aval_Shakhs2,,,0,2,2,0,5,5,1,1,1,0,18,0.00018
AvayeMontazeran,,,0,1,1,0,2,2,1,1,1,0,95,0.00018
Avazepare,,,0,1,1,0,1,1,1,1,1,0,96,0.00018
shaqaiieq70,,,4,0,4,4,0,4,0,0,0,0,96,0.000796
Avesta908,,,0,2,2,0,3,3,1,1,1,0,18,0.00018
AwHichii,,,0,1,1,0,1,1,1,1,1,0,18,0.00018
Ayrin46868497,,,0,5,5,0,12,12,1,1,1,0,95,0.00018
aliahmadian100,,,1,0,1,1,0,1,0,0,0,0,95,0.000211
arghavan11267,,,1,0,1,2,0,2,0,0,0,0,95,0.000211
shokri78,,,1,0,1,2,0,2,0,0,0,0,95,0.000211
tow_morning,,,2,0,2,4,0,4,0,0,0,0,95,0.000242
AysanZarfam,,,0,1,1,0,2,2,1,1,1,0,97,0.00018
zahrakeshvari,,,1,0,1,2,0,2,0,0,0,0,97,0.000334
Ayyeneh,,,0,1,1,0,2,2,2,0.6,0.666667,0,18,0.00018
AzNakojaAbad,,,0,1,1,0,1,1,1,1,1,0,77,0.00018
Azad77919645,,,0,1,1,0,1,1,1,1,1,0,18,0.00018
AzadProtest,,,0,9,9,0,14,14,1,1,1,0,18,0.00018
amir_Lor,,,1,0,1,1,0,1,0,0,0,0,18,0.000198
hichkehich,,,1,0,1,1,0,1,0,0,0,0,18,0.000198
AzadVida,,,0,2,2,0,4,4,1,1,1,0,95,0.00018
Masume_mst,,,2,0,2,2,0,2,0,0,0,0,95,0.00026
AzadeRafiei,,,0,2,2,0,3,3,1,1,1,0,142,0.00018
farazamann,,,1,0,1,2,0,2,0,0,0,0,142,0.000257
AzadeTehrani,,,0,1,1,0,1,1,1,1,1,0,77,0.00018
Azadeh28153402,,,0,1,1,0,1,1,1,1,1,0,18,0.00018
AzadehAssadi,,,0,1,1,0,2,2,1,1,1,0,18,0.00018
Azadi12345,,,0,1,1,0,1,1,1,1,1,0,18,0.00018
AzadiMahi,,,0,1,1,0,1,1,1,1,1,0,18,0.00018
Azadi_313kh,,,0,2,2,0,3,3,2,0.75,0.833333,0,95,0.00018
Azadii99,,,0,4,4,0,5,5,1,1,1,0,95,0.00018
dw_persian,,,1,0,1,1,0,1,0,0,0,0,95,0.000219
yjcagency,,,1,0,1,2,0,2,0,0,0,0,95,0.000219
Azadmard15,,,0,1,1,0,2,2,1,1,1,0,18,0.00018
ShakouryR,,,1,0,1,2,0,2,0,0,0,0,77,0.000438
AzamRasti,,,0,3,3,0,5,5,1,1,1,0,77,0.00018
arghanon,,,5,0,5,10,0,10,0,0,0,0,77,0.000672
Azamfz66,,,2,1,3,6,1,7,1,1,1,1,95,0.000365
AzarMaaliNasab,,,0,1,1,0,1,1,1,1,1,0,18,0.00018
AzarakhshNader,,,0,3,3,0,6,6,1,1,1,0,18,0.00018
AzardokhtP,,,0,1,1,0,1,1,1,1,1,0,18,0.00018
AzarnooshMoradi,,,0,1,1,0,6,6,1,1,1,0,18,0.00018
arashtam66,,,5,0,5,25,0,25,0,0,0,0,18,0.000604
AzimiKamal,,,0,1,1,0,3,3,1,1,1,0,12,0.00018
Azin41448499,,,0,1,1,0,2,2,1,1,1,0,18,0.00018
Azizeh_zeinali,,,0,2,2,0,6,6,1,1,1,0,95,0.00018
Moraghaji,,,3,0,3,6,0,6,0,0,0,0,95,0.000433
B6889Sh,,,0,5,5,0,9,9,1,1,1,0,95,0.00018
raefipourfan,,,3,0,3,15,0,15,0,0,0,0,95,0.000519
BABACHAH,,,0,7,7,0,14,14,1,1,1,0,95,0.00018
hoshyar313,,,1,0,1,2,0,2,0,0,0,0,95,0.000202
saajjjjjjjaad,,,4,0,4,8,0,8,0,0,0,0,95,0.000383
BABAKHORM,,,0,1,1,0,3,3,1,1,1,0,18,0.00018
BAZ2EET,,,0,5,5,0,7,7,1,1,1,0,18,0.00018
BBCPBUH1,,,0,5,5,0,9,9,2,0.608696,0.678571,0,18,0.00018
Smirnoff_ferfer,,,1,0,1,1,0,1,0,0,0,0,18,0.00034
BEntezami,,,1,4,5,1,8,9,1,1,1,0,77,0.00018
nazokbin_ir,,,5,0,5,14,0,14,0,0,0,0,77,0.00045
Samanrizbin,,,1,0,1,1,0,1,0,0,0,0,18,0.000238
captain_drunk,,,1,0,1,2,0,2,0,0,0,0,18,0.000238
khaamenei_ir,,,2,0,2,3,0,3,0,0,0,0,18,0.000252
shalilforoosh,,,1,0,1,1,0,1,0,0,0,0,18,0.000238
BNeyestaan,,,0,1,1,0,2,2,1,1,1,0,77,0.00018
BOzmArafteNezam,,,0,3,3,0,6,6,1,1,1,0,18,0.00018
Ms79744326,,,6,0,6,6,0,6,0,0,0,0,18,0.000449
BPourhossein,,,0,1,1,0,1,1,1,1,1,0,18,0.00018
Baarmaakh,,,0,3,3,0,5,5,1,1,1,0,95,0.00018
Bab68156389,,,1,1,2,1,1,2,0,0,0,0,98,0.00018
BabackAshtari,,,0,2,2,0,2,2,6,0.228346,0.260632,0,18,0.00018
Farshad_khanii,,,1,1,2,1,3,4,5,0.285714,0.316369,56,18,0.000257
Babak807,,,0,3,3,0,3,3,1,1,1,0,18,0.00018
Babak83902275,,,0,1,1,0,1,1,1,1,1,0,18,0.00018
BabakBayanian,,,0,1,1,0,2,2,1,1,1,0,77,0.00018
BabakDanzo,,,0,7,7,0,9,9,3,0.607143,0.696078,0,18,0.00018
BabakIrandoust,,,0,1,1,0,2,2,1,1,1,0,18,0.00018
BabakKhorammdin,,,0,1,1,0,1,1,1,1,1,0,18,0.00018
Secularism_Iran,,,2,0,2,2,0,2,0,0,0,0,18,0.000386
BabakM67089271,,,0,1,1,0,1,1,1,1,1,0,18,0.00018
BabakR82,,,0,3,3,0,4,4,1,1,1,0,18,0.00018
AliAshtari9,,,2,0,2,2,0,2,0,0,0,0,18,0.000309
BabakSalami,,,0,1,1,0,2,2,1,1,1,0,95,0.00018
zeinabHasani135,,,2,0,2,4,0,4,0,0,0,0,95,0.000356
Babak_J_T,,,0,4,4,0,15,15,1,1,1,0,18,0.00018
KayhanLondon,,,1,0,1,9,0,9,0,0,0,0,18,0.000219
doshmanealesood,,,1,0,1,2,0,2,0,0,0,0,95,0.000207
Babakhan0001,,,0,4,4,0,6,6,2,0.833333,0.9,0,95,0.00018
KHAT_SHOHADA,,,2,1,3,2,2,4,1,1,1,2,95,0.00022
Babakkhoramdiin,,,0,4,4,0,5,5,1,1,1,0,18,0.00018
Babakoohi1,,,0,1,1,0,1,1,1,1,1,0,77,0.00018
Babaksss,,,0,1,1,0,1,1,1,1,1,0,77,0.00018
Babrajson,,,0,1,1,0,1,1,2,0.555556,0.6,0,18,0.00018
BabreSabr,,,0,1,1,0,2,2,1,1,1,0,18,0.00018
BacheHooshang,,,0,1,1,0,1,1,1,1,1,0,95,0.00018
Bagher_pour_7,,,0,4,4,0,4,4,1,1,1,0,95,0.00018
Parnian_hoseini,,,2,0,2,2,0,2,0,0,0,0,95,0.000222
BagimsizGuneyAz,,,0,1,1,0,1,1,1,1,1,0,99,0.00018
mahshidmsy,,,1,0,1,1,0,1,0,0,0,0,99,0.000334
BagwellTea,,,0,4,4,0,8,8,5,0.31746,0.395,0,18,0.00018
BehrangArash,,,1,0,1,1,0,1,0,0,0,0,18,0.000219
BahaarH68,,,0,1,1,0,1,1,1,1,1,0,77,0.00018
Bahar14564235,,,0,4,4,0,9,9,1,1,1,0,95,0.00018
Bahar78619093,,,0,1,1,0,1,1,1,1,1,0,77,0.00018
Bahar82R,,,0,2,2,0,4,4,1,1,1,0,100,0.00018
Samiryan9,,,1,0,1,2,0,2,0,0,0,0,100,0.000257
zahra_e_marzie,,,1,0,1,2,0,2,0,0,0,0,100,0.000257
Baharan1350,,,0,3,3,0,6,6,1,1,1,0,77,0.00018
Baharbanoo4,,,0,3,3,0,6,6,1,1,1,0,95,0.00018
Bahareh_Iran,,,1,3,4,1,4,5,3,0.538462,0.595238,160.5,18,0.000229
BahariPeyman,,,0,1,1,0,2,2,1,1,1,0,18,0.00018
BaharlooOmid,,,0,1,1,0,3,3,1,1,1,0,95,0.00018
Bahman83764439,,,0,2,2,0,3,3,1,1,1,0,18,0.00018
allamehmajlesi,,,1,0,1,1,0,1,0,0,0,0,18,0.000257
BahmanAmouee,,,0,1,1,0,1,1,1,1,1,0,77,0.00018
BahmanSwiss,,,0,1,1,0,1,1,1,1,1,0,18,0.00018
BahmaniFarshad,,,0,1,1,0,2,2,1,1,1,0,101,0.00018
mokkaddar,,,1,0,1,2,0,2,0,0,0,0,101,0.000334
BahmaniSaeid,,,0,1,1,0,1,1,1,1,1,0,95,0.00018
BahreiniSayed,,,0,5,5,0,7,7,1,1,1,0,95,0.00018
Miladfeyzi1,,,2,0,2,2,0,2,0,0,0,0,95,0.000564
Pormohammad2703,,,3,0,3,14,0,14,0,0,0,0,95,0.00026
basijparand,,,2,0,2,2,0,2,0,0,0,0,95,0.000288
komeil_213,,,2,0,2,2,0,2,0,0,0,0,95,0.000365
Balazadeh1,,,0,1,1,0,2,2,1,1,1,0,95,0.00018
BamatSefid,,,0,1,1,0,1,1,1,1,1,0,77,0.00018
Mehdiahmadpour4,,,1,0,1,1,0,1,0,0,0,0,95,0.000335
BanoSadat1,,,0,9,9,0,15,15,1,1,1,0,95,0.00018
hasghari3,,,2,0,2,5,0,5,0,0,0,0,95,0.000202
meysam_zlf,,,1,0,1,1,0,1,0,0,0,0,95,0.000198
Banoo_z128,,,0,1,1,0,1,1,1,1,1,0,95,0.00018
BarBord3,,,0,1,1,0,1,1,1,1,1,0,102,0.00018
KatrinAsgarian,,,1,0,1,1,0,1,0,0,0,0,102,0.000334
BaraieRobab,,,0,1,1,0,1,1,1,1,1,0,12,0.00018
Baran32091367,,,1,3,4,1,10,11,1,1,1,2,18,0.000232
Shamshirsiavash,,,1,0,1,1,0,1,0,0,0,0,18,0.000246
Baran61970374,,,0,5,5,0,8,8,2,0.727273,0.8125,0,95,0.00018
Baran73894188,,,0,1,1,0,3,3,1,1,1,0,95,0.00018
BaranHosseini1,,,0,5,5,0,7,7,2,0.777778,0.857143,0,95,0.00018
bargepaiz,,,3,0,3,6,0,6,0,0,0,0,95,0.000222
saabedi70,,,6,0,6,12,0,12,0,0,0,0,95,0.000552
Barana09061825,,,0,1,1,0,2,2,1,1,1,0,18,0.00018
Barbad77,,,0,1,1,0,1,1,1,1,1,0,18,0.00018
Barbaro54331887,,,0,1,1,0,3,3,1,1,1,0,18,0.00018
Bardia07348539,,,0,1,1,0,1,1,1,1,1,0,18,0.00018
BardiaS3,,,0,1,1,0,2,2,2,0.6,0.666667,0,18,0.00018
BarekYoussef1,,,0,2,2,0,4,4,1,1,1,0,95,0.00018
Barfofgod,,,0,1,1,0,1,1,1,1,1,0,96,0.00018
BarkhordarV,,,0,1,1,0,1,1,1,1,1,0,12,0.00018
Barunaki,,,0,1,1,0,1,1,1,1,1,0,77,0.00018
BarzinMorteza,,,0,1,1,0,1,1,1,1,1,0,18,0.00018
Bastee51,,,0,1,1,0,2,2,1,1,1,0,18,0.00018
Baughebaun,,,0,3,3,0,5,5,1,1,1,0,95,0.00018
maryam_shavandi,,,1,0,1,2,0,2,0,0,0,0,95,0.000232
Bavarian_man77,,,0,1,1,0,1,1,3,0.5,0.527778,0,18,0.00018
Bayani63,,,0,1,1,0,2,2,1,1,1,0,77,0.00018
BazgashteBozorg,,,0,5,5,0,9,9,3,0.55,0.681818,0,12,0.00018
porseshgaram,,,1,0,1,1,0,1,0,0,0,0,12,0.000211
rezaparchizadeh,,,2,0,2,3,0,3,0,0,0,0,12,0.000288
Bazgashtehh,,,0,4,4,0,7,7,2,0.833333,0.9,0,18,0.00018
BazrasJ,,,0,1,1,0,1,1,1,1,1,0,77,0.00018
SangareEnghelab,,,1,0,1,1,0,1,0,0,0,0,95,0.000258
siavosh_piami,,,1,0,1,1,0,1,0,0,0,0,95,0.000258
Be95388690,,,0,1,1,0,3,3,1,1,1,0,103,0.00018
heydari_m76,,,1,0,1,3,0,3,0,0,0,0,103,0.000334
Beauty22126938,,,0,2,2,0,4,4,1,1,1,0,95,0.00018
BeautyfulMindi,,,0,1,1,0,2,2,1,1,1,0,18,0.00018
BehhroozI,,,0,2,2,0,4,4,2,0.666667,0.75,0,95,0.00018
BehiGity,,,2,2,4,3,2,5,1,1,1,4,18,0.00025
ss_jjann,,,1,0,1,1,0,1,0,0,0,0,18,0.000287
Behnamtarin2,,,0,1,1,0,1,1,1,1,1,0,104,0.00018
iammonana,,,1,0,1,1,0,1,0,0,0,0,104,0.000334
Behrad_xan,,,0,1,1,0,1,1,1,1,1,0,95,0.00018
Behrang32662821,,,0,1,1,0,3,3,1,1,1,0,47,0.00018
Behrooz42345368,,,0,3,3,0,6,6,2,0.636364,0.714286,0,18,0.00018
BehroozBahary,,,0,1,1,0,1,1,1,1,1,0,12,0.00018
Behrouz18356770,,,1,4,5,2,9,11,1,1,1,4,77,0.000257
jostejougar1,,,3,0,3,3,0,3,0,0,0,0,77,0.000334
BehshadJavid,,,0,1,1,0,1,1,1,1,1,0,77,0.00018
Behzad39873943,,,0,1,1,0,2,2,1,1,1,0,95,0.00018
Behzad49519166,,,0,4,4,0,5,5,1,1,1,0,18,0.00018
Belacheh,,,0,1,1,0,2,2,1,1,1,0,95,0.00018
Benjamin0688601,,,0,2,2,0,2,2,1,1,1,0,77,0.00018
Benjen_mg,,,0,2,2,0,3,3,1,1,1,0,18,0.00018
Benking71,,,0,1,1,0,1,1,1,1,1,0,77,0.00018
Bentelhoda619,,,0,2,2,0,3,3,1,1,1,0,105,0.00018
ammar_sanaei,,,1,0,1,1,0,1,0,0,0,0,105,0.000257
mojtabaazad1371,,,1,0,1,2,0,2,0,0,0,0,105,0.000257
Beren7495,,,0,1,1,0,1,1,1,1,1,0,77,0.00018
Bernadotttt,,,0,1,1,0,2,2,1,1,1,0,18,0.00018
BetisRf,,,0,2,2,0,2,2,1,1,1,0,77,0.00018
BfRdJGFkqGg4C8a,,,0,2,2,0,4,4,1,1,1,0,95,0.00018
setarehtanhayii,,,1,0,1,2,0,2,0,0,0,0,95,0.000257
BhashemiSara,,,0,3,3,0,6,6,1,1,1,0,95,0.00018
Bhdblo,,,0,2,2,0,4,4,1,1,1,0,77,0.00018
BiSarOSamaN,,,0,1,1,0,2,2,1,1,1,0,95,0.00018
BiYiXlY,,,0,1,1,0,1,1,1,1,1,0,96,0.00018
Biabooni,,,0,4,4,0,5,5,2,0.666667,0.75,0,18,0.00018
Bidandooon,,,0,1,1,0,6,6,1,1,1,0,29,0.00018
BidarBash99,,,0,1,1,0,1,1,1,1,1,0,95,0.00018
BijanKiarsi,,,0,1,1,0,1,1,1,1,1,0,18,0.00018
saeedsfj,,,2,0,2,2,0,2,0,0,0,0,18,0.000411
BijanSeifi,,,0,2,2,0,3,3,1,1,1,0,18,0.00018
Sr4_Avenger,,,1,0,1,2,0,2,0,0,0,0,18,0.000257
Bikhabaroffline,,,0,3,3,0,4,4,1,1,1,0,18,0.00018
Binam25,,,0,1,1,0,5,5,1,1,1,0,106,0.00018
Binamm5,,,1,0,1,5,0,5,0,0,0,0,106,0.000334
Binamoneshon5,,,0,3,3,0,5,5,1,1,1,0,107,0.00018
L315Ko,,,1,0,1,3,0,3,0,0,0,0,107,0.000232
jahadefarhangi,,,1,0,1,1,0,1,0,0,0,0,107,0.000232
Bingbon08050843,,,0,1,1,0,2,2,1,1,1,0,18,0.00018
Birdie07161975,,,0,1,1,0,1,1,1,1,1,0,108,0.00018
Mosseen3,,,1,0,1,1,0,1,0,0,0,0,108,0.000334
Bisimchi_,,,0,1,1,0,1,1,1,1,1,0,109,0.00018
shey2nakk,,,1,0,1,1,0,1,0,0,0,0,109,0.000334
Bita2018,,,0,9,9,0,11,11,2,0.621622,0.695652,0,18,0.00018
AliGhayed,,,4,0,4,12,0,12,0,0,0,0,18,0.000385
Sandisodoleh,,,1,0,1,1,0,1,0,0,0,0,18,0.000198
baranibb,,,1,0,1,1,0,1,0,0,0,0,18,0.000198
gambit_2019,,,2,0,2,2,0,2,0,0,0,0,18,0.000264
BiuckAmir,,,1,1,2,1,1,2,5,0.304,0.35,37,18,0.000202
BlackOwl65,,,0,1,1,0,1,1,2,0.555556,0.6,0,18,0.00018
BlimatJaran,,,0,1,1,0,2,2,1,1,1,0,110,0.00018
hemmati_naser,,,3,0,3,6,0,6,0,0,0,0,110,0.000642
Blockedpeterson,,,0,1,1,0,1,1,1,1,1,0,77,0.00018
Blue3x3z,,,0,1,1,0,3,3,2,0.666667,0.75,0,18,0.00018
KHBavrian,,,2,1,3,6,2,8,1,1,1,2,18,0.000488
Blue52190086,,,0,8,8,0,9,9,1,1,1,0,18,0.00018
dragon300300,,,5,0,5,5,0,5,0,0,0,0,18,0.000274
BlueBer40559319,,,0,1,1,0,1,1,1,1,1,0,77,0.00018
BluePhoenixIR,,,0,1,1,0,2,2,1,1,1,0,95,0.00018
Bmyaprilshowers,,,0,2,2,0,4,4,1,1,1,0,18,0.00018
BnMatin,,,0,1,1,0,2,2,1,1,1,0,95,0.00018
BnmRdbd,,,0,1,1,0,1,1,1,1,1,0,77,0.00018
BnnqH6vQpycCuiU,,,0,4,4,0,4,4,1,1,1,0,77,0.00018
Bohogirl3,,,0,1,1,0,1,1,1,1,1,0,18,0.00018
BoloukiMohammad,,,0,1,1,0,2,2,1,1,1,0,95,0.00018
vahidreza_m,,,2,0,2,4,0,4,0,0,0,0,95,0.000337
Borhan792000,,,0,1,1,0,1,1,1,1,1,0,111,0.00018
sheikh_beiraghy,,,1,0,1,1,0,1,0,0,0,0,111,0.000334
Bozorgm90460643,,,0,3,3,0,9,9,2,0.636364,0.714286,0,18,0.00018
Br_Hearts2233,,,0,7,7,0,11,11,1,1,1,0,95,0.00018
BtRASsZz,,,0,2,2,0,3,3,1,1,1,0,77,0.00018
Buajeh,,,0,1,1,0,1,1,1,1,1,0,18,0.00018
alaf052,,,1,0,1,2,0,2,0,0,0,0,18,0.000224
tafsir_namizan,,,1,0,1,2,0,2,0,0,0,0,18,0.000224
Bye_Kramer,,,0,1,1,0,1,1,1,1,1,0,18,0.00018
CAPilarcraft,,,0,5,5,0,6,6,2,0.692308,0.777778,0,18,0.00018
persianhuman,,,4,0,4,6,0,6,0,0,0,0,18,0.000402
CHIEF_UI,,,0,1,1,0,1,1,1,1,1,0,112,0.00018
Stewie_griffinm,,,6,0,6,6,0,6,0,0,0,0,112,0.001104
CIRO_PARSI,,,0,1,1,0,1,1,1,1,1,0,113,0.00018
Raha74381937,,,1,0,1,1,0,1,0,0,0,0,113,0.000334
CIojouQXbssco3Y,,,0,3,3,0,6,6,1,1,1,0,95,0.00018
iwebnevis,,,4,0,4,6,0,6,0,0,0,0,95,0.000275
maryamrostamy,,,1,0,1,2,0,2,0,0,0,0,95,0.000232
CPHMFree,,,0,1,1,0,2,2,1,1,1,0,87,0.00018
CSCR_Ir,,,0,3,3,0,6,6,2,0.8,0.875,0,95,0.00018
Fatimah_1727,,,1,1,2,2,2,4,1,1,1,1,95,0.000232
Caardinaal,,,0,2,2,0,2,2,1,1,1,0,18,0.00018
CactusTurquoise,,,0,4,4,0,6,6,1,1,1,0,18,0.00018
Caleb74287391,,,0,4,4,0,5,5,1,1,1,0,18,0.00018
Call_me_Hans,,,0,1,1,0,1,1,1,1,1,0,18,0.00018
CamaroTotti,,,0,1,1,0,1,1,1,1,1,0,5,0.00018
CaptainAsprin,,,0,2,2,0,3,3,1,1,1,0,18,0.00018
CaptainMohsenGH,,,0,1,1,0,1,1,1,1,1,0,95,0.00018
CaptainNemati,,,0,3,3,0,6,6,1,1,1,0,95,0.00018
S_f_Sajedi,,,1,0,1,1,0,1,0,0,0,0,95,0.000232
jacoobkarimi,,,3,0,3,6,0,6,0,0,0,0,95,0.000319
Caramello2quett,,,0,1,1,0,1,1,1,1,1,0,77,0.00018
Carl_McLaren_,,,0,2,2,0,2,2,1,1,1,0,18,0.00018
CasaGatto,,,0,12,12,0,16,16,2,0.6875,0.772727,0,18,0.00018
Ceeiid,,,0,1,1,0,4,4,1,1,1,0,95,0.00018
CenaDM,,,0,1,1,0,1,1,1,1,1,0,18,0.00018
CesVbSyKqxsXlcs,,,0,1,1,0,2,2,1,1,1,0,114,0.00018
ahambel128,,,1,0,1,2,0,2,0,0,0,0,114,0.000334
CharlesLiberal,,,0,3,3,0,3,3,1,1,1,0,18,0.00018
CharlzGh,,,0,1,1,0,1,1,1,1,1,0,115,0.00018
yaghma_fashkham,,,1,0,1,1,0,1,0,0,0,0,115,0.000334
ChaudhryNouman7,,,0,1,1,0,1,1,1,1,1,0,158,0.00018
Chavoshiroya,,,0,2,2,0,5,5,1,1,1,0,18,0.00018
Chekhov_mr,,,0,4,4,0,6,6,2,0.666667,0.75,0,18,0.00018
Cheraghalikh,,,0,1,1,0,2,2,1,1,1,0,95,0.00018
Cherikenghelabi,,,0,1,1,0,1,1,1,1,1,0,116,0.00018
DrRevolutionary,,,2,1,3,2,1,3,0,0,0,0,116,0.000334
ChetoriArzeshi,,,2,7,9,4,22,26,2,0.888889,0.9375,16,18,0.000233
Sibilooo1994,,,1,0,1,4,0,4,0,0,0,0,18,0.000209
taboo_shekan,,,3,0,3,3,0,3,0,0,0,0,18,0.000368
Cheval92209936,,,0,1,1,0,1,1,1,1,1,0,18,0.00018
Chichra11,,,0,1,1,0,1,1,1,1,1,0,28,0.00018
Chissttaa,,,0,1,1,0,1,1,1,1,1,0,52,0.00018
Chiya_A6,,,0,2,2,0,2,2,1,1,1,0,18,0.00018
Cilia1992,,,0,1,1,0,1,1,1,1,1,0,18,0.00018
Cinderellaoooo,,,0,3,3,0,6,6,1,1,1,0,18,0.00018
Clit_911_Oris,,,0,1,1,0,1,1,2,0.6,0.666667,0,18,0.00018
Cnautumn,,,0,1,1,0,1,1,1,1,1,0,95,0.00018
Cnsa8492,,,0,3,3,0,7,7,1,1,1,0,18,0.00018
scorpio14865676,,,1,0,1,3,0,3,0,0,0,0,18,0.000232
Cobalt_Head,,,0,1,1,0,1,1,1,1,1,0,18,0.00018
Colemanlamont74,,,0,1,1,0,1,1,1,1,1,0,18,0.00018
ColonelKurtz17,,,0,1,1,0,1,1,1,1,1,0,18,0.00018
CommanderReza,,,0,1,1,0,1,1,1,1,1,0,117,0.00018
Verkhovensky_ST,,,1,0,1,1,0,1,0,0,0,0,117,0.000334
Comrade1979,,,0,1,1,0,3,3,1,1,1,0,95,0.00018
ComunidadesI,,,0,1,1,0,1,1,1,1,1,0,12,0.00018
ConceivedOnset,,,0,1,1,0,2,2,1,1,1,0,18,0.00018
Cosmologist_DE,,,0,1,1,0,1,1,1,1,1,0,77,0.00018
Cparastoo,,,0,1,1,0,1,1,1,1,1,0,18,0.00018
CqMuC3TxiKqZLjO,,,0,1,1,0,1,1,1,1,1,0,95,0.00018
Cr_Pholan,,,0,1,1,0,1,1,1,1,1,0,112,0.00018
Cristoferrabin,,,0,2,2,0,3,3,1,1,1,0,18,0.00018
Croft2221,,,0,1,1,0,1,1,1,1,1,0,112,0.00018
Cryptalist,,,0,1,1,0,1,1,1,1,1,0,18,0.00018
Cryptonarchisto,,,0,2,2,0,2,2,1,1,1,0,18,0.00018
Milan_Samari,,,2,0,2,3,0,3,0,0,0,0,18,0.000309
tatsuya_nakadai,,,1,0,1,1,0,1,0,0,0,0,18,0.000257
Cuttlas6,,,0,1,1,0,1,1,1,1,1,0,18,0.00018
Cyberdemonrises,,,0,1,1,0,1,1,2,0.6,0.666667,0,18,0.00018
D0khtarak,,,0,1,1,0,2,2,1,1,1,0,110,0.00018
D7GGxRJWN7lwzOC,,,0,2,2,0,4,4,1,1,1,0,118,0.00018
nana51583306,,,1,0,1,2,0,2,0,0,0,0,118,0.000257
siasatkhaste,,,1,0,1,2,0,2,0,0,0,0,118,0.000257
DARK_KNIGHTE19,,,0,1,1,0,1,1,1,1,1,0,18,0.00018
DKdEQtycvNfnETT,,,0,1,1,0,4,4,1,1,1,0,18,0.00018
DKhanoom,,,0,1,1,0,2,2,1,1,1,0,95,0.00018
DN8hSccfh7F9Hhq,,,0,1,1,0,1,1,1,1,1,0,95,0.00018
DZkrMECNEQZyPva,,,0,1,1,0,1,1,1,1,1,0,77,0.00018
Daaghaan,,,0,1,1,0,1,1,1,1,1,0,18,0.00018
Daddybarqy,,,0,1,1,0,1,1,1,1,1,0,95,0.00018
DaeeMahyar,,,0,2,2,0,2,2,1,1,1,0,12,0.00018
hadimody1,,,1,0,1,1,0,1,0,0,0,0,12,0.000257
Dakhoo5,,,0,1,1,0,1,1,1,1,1,0,95,0.00018
h_abediha,,,2,0,2,2,0,2,0,0,0,0,95,0.000373
Damla_Red,,,0,1,1,0,1,1,1,1,1,0,96,0.00018
Dana2578,,,0,2,2,0,2,2,1,1,1,0,18,0.00018
DanakReza,,,0,2,2,0,2,2,1,1,1,0,12,0.00018
Dandelion681,,,0,1,1,0,1,1,1,1,1,0,77,0.00018
Daneshjoo13,,,0,1,1,0,2,2,1,1,1,0,119,0.00018
borzoorafiee,,,1,0,1,2,0,2,0,0,0,0,119,0.000334
Daneshmand17,,,0,1,1,0,1,1,1,1,1,0,12,0.00018
DanialNBiS,,,0,3,3,0,6,6,1,1,1,0,95,0.00018
Danialjordialba,,,0,1,1,0,1,1,1,1,1,0,18,0.00018
Daniel25201047,,,0,1,1,0,1,1,2,0.6,0.666667,0,18,0.00018
Daniyal1335,,,0,2,2,0,5,5,2,0.75,0.833333,0,18,0.00018
Daniyal51373869,,,0,2,2,0,3,3,1,1,1,0,18,0.00018
Dar_Colosseum,,,0,1,1,0,1,1,1,1,1,0,120,0.00018
Osyan_gar,,,1,0,1,1,0,1,0,0,0,0,120,0.000334
DaraSabor,,,0,4,4,0,4,4,1,1,1,0,18,0.00018
DarabiAliashraf,,,0,4,4,0,4,4,1,1,1,0,18,0.00018
naghimamuly,,,1,0,1,1,0,1,0,0,0,0,18,0.000219
DariushAshuri,,,0,1,1,0,2,2,1,1,1,0,121,0.00018
rekashef,,,1,0,1,2,0,2,0,0,0,0,121,0.000334
Dark_Black_Red,,,0,1,1,0,2,2,1,1,1,0,77,0.00018
DarkafeY,,,0,1,1,0,1,1,1,1,1,0,95,0.00018
Darkday79657836,,,0,1,1,0,1,1,1,1,1,0,77,0.00018
Darkddandy,,,0,2,2,0,2,2,1,1,1,0,18,0.00018
Darkkub,,,0,2,2,0,2,2,5,0.309524,0.366667,0,18,0.00018
DarknessQuery,,,0,1,1,0,2,2,1,1,1,0,18,0.00018
DaryaMehran,,,0,3,3,0,5,5,1,1,1,0,18,0.00018
Darya_112233,,,0,11,11,0,25,25,2,0.923077,0.958333,0,95,0.00018
Farzaneh46400,,,1,0,1,2,0,2,0,0,0,0,95,0.000194
setarehsamami,,,1,0,1,2,0,2,0,0,0,0,95,0.000194
sp_rahimi,,,1,0,1,2,0,2,0,0,0,0,95,0.000194
Daryous44579268,,,0,6,6,0,7,7,1,1,1,0,18,0.00018
MaryamAdibian,,,3,0,3,3,0,3,0,0,0,0,18,0.000398
PSipy,,,1,0,1,1,0,1,0,0,0,0,18,0.000206
meynooshh,,,1,0,1,1,0,1,0,0,0,0,18,0.000206
DaryushSalahsh4,,,0,4,4,0,6,6,1,1,1,0,18,0.00018
alinick2019,,,1,0,1,1,0,1,0,0,0,0,18,0.000219
salahshurdarus1,,,1,0,1,1,0,1,0,0,0,0,18,0.000219
DaryushSalahsh5,,,1,1,2,2,2,4,0,0,0,0,122,0.00018
Dast_Be_Ghalam,,,0,1,1,0,1,1,1,1,1,0,95,0.00018
DaughterYalda,,,1,5,6,1,6,7,1,1,1,0,95,0.00018
hamedhasani69,,,2,0,2,2,0,2,0,0,0,0,95,0.000267
zohreh4996,,,3,0,3,3,0,3,0,0,0,0,95,0.000268
DavooZamani,,,0,1,1,0,1,1,1,1,1,0,77,0.00018
DavoodRamin,,,0,3,3,0,4,4,1,1,1,0,77,0.00018
De_Selby_,,,0,1,1,0,2,2,1,1,1,0,18,0.00018
Deejay1_30,,,0,13,13,0,18,18,1,1,1,0,18,0.00018
saintporya,,,3,0,3,3,0,3,0,0,0,0,18,0.00036
DefenderPti,,,0,1,1,0,1,1,1,1,1,0,158,0.00018
Dehghannnnn,,,0,1,1,0,2,2,1,1,1,0,77,0.00018
Delaram_daryai,,,0,5,5,0,11,11,2,0.857143,0.916667,0,95,0.00018
Iranbanoojan1,,,1,1,2,2,1,3,1,1,1,1,95,0.000211
DeleKhamoosh,,,0,1,1,0,1,1,1,1,1,0,18,0.00018
Jebhemeli,,,2,0,2,2,0,2,0,0,0,0,18,0.000386
DeliSeifi,,,0,1,1,0,2,2,1,1,1,0,95,0.00018
Delkashsh,,,0,1,1,0,1,1,1,1,1,0,112,0.00018
Demir13527085,,,0,8,8,0,12,12,2,0.617647,0.690476,0,18,0.00018
DenDenmehban,,,0,1,1,0,2,2,1,1,1,0,18,0.00018
DenaG_M,,,0,1,1,0,1,1,1,1,1,0,77,0.00018
Depsordeh,,,0,1,1,0,1,1,1,1,1,0,18,0.00018
DerNichts,,,0,1,1,0,1,1,1,1,1,0,18,0.00018
DexterKaviani,,,0,2,2,0,2,2,1,1,1,0,18,0.00018
HZjaguar,,,1,0,1,1,0,1,0,0,0,0,18,0.000257
DibiOfficial,,,5,1,6,10,2,12,0,0,0,0,95,0.000482
DictatorRemoval,,,0,1,1,0,1,1,1,1,1,0,18,0.00018
Didehbanenghel2,,,0,1,1,0,2,2,1,1,1,0,95,0.00018
DieFreiLuft,,,0,1,1,0,1,1,1,1,1,0,77,0.00018
DinaBrzd,,,0,4,4,0,5,5,1,1,1,0,77,0.00018
NafisMohamadpou,,,2,0,2,2,0,2,0,0,0,0,77,0.00027
m_apathetical,,,2,0,2,4,0,4,0,0,0,0,77,0.000296
Dino09093877,,,0,1,1,0,1,1,1,1,1,0,123,0.00018
gladiator0912,,,1,0,1,1,0,1,0,0,0,0,123,0.000334
Diverted0,,,0,1,1,0,1,1,1,1,1,0,124,0.00018
naghashbashiii,,,1,0,1,1,0,1,0,0,0,0,124,0.000334
DjPashmakk,,,0,2,2,0,2,2,1,1,1,0,77,0.00018
Dmari_110,,,1,1,2,3,1,4,1,1,1,0,95,0.000181
Dnrg3nha52cfQLQ,,,0,1,1,0,1,1,1,1,1,0,77,0.00018
DoGaulle,,,1,1,2,1,1,2,0,0,0,0,125,0.00018
DoctorDoom2,,,0,2,2,0,2,2,1,1,1,0,18,0.00018
DokhtarShabgard,,,0,1,1,0,1,1,1,1,1,0,18,0.00018
Dokhtar_Aftabbb,,,0,4,4,0,7,7,1,1,1,0,95,0.00018
m_khorasanizade,,,1,0,1,2,0,2,0,0,0,0,95,0.000219
DokhtarbaharS,,,0,1,1,0,2,2,1,1,1,0,95,0.00018
DokhtarePaizamm,,,0,2,2,0,3,3,1,1,1,0,95,0.00018
Dokhtareanshan,,,0,1,1,0,2,2,1,1,1,0,95,0.00018
Dokhtarebahar2,,,0,1,1,0,2,2,1,1,1,0,126,0.00018
demokracy,,,1,0,1,2,0,2,0,0,0,0,126,0.000334
Dokhtaremardom4,,,0,4,4,0,6,6,1,1,1,0,77,0.00018
SharafiSima,,,1,0,1,2,0,2,0,0,0,0,77,0.000219
marym_book,,,1,0,1,1,0,1,0,0,0,0,77,0.000219
pajoohesh1402,,,1,0,1,2,0,2,0,0,0,0,77,0.000219
DokhtarenGhlab,,,0,2,2,0,4,4,1,1,1,0,95,0.00018
smhm1374,,,1,0,1,2,0,2,0,0,0,0,95,0.000257
Dokhte_Iranam,,,0,4,4,0,17,17,1,1,1,0,95,0.00018
Mahbano18,,,1,0,1,1,0,1,0,0,0,0,95,0.000219
NasimVelayat,,,2,0,2,4,0,4,0,0,0,0,95,0.00027
ghoghnos_21,,,3,0,3,7,0,7,0,0,0,0,95,0.000424
Dome_khorous,,,0,4,4,0,7,7,2,0.666667,0.75,0,18,0.00018
Dominic11212337,,,0,7,7,0,9,9,2,0.818182,0.888889,0,18,0.00018
DonAdammmmm,,,0,1,1,0,1,1,1,1,1,0,127,0.00018
joseph9901,,,1,0,1,1,0,1,0,0,0,0,127,0.000334
DonDiegoo1,,,0,10,10,0,16,16,1,1,1,0,95,0.00018
azdamher,,,2,0,2,4,0,4,0,0,0,0,95,0.000206
mr_albrt,,,5,0,5,5,0,5,0,0,0,0,95,0.00021
Don_zand,,,0,1,1,0,1,1,2,0.666667,0.75,0,18,0.00018
Donbalanian,,,0,1,1,0,2,2,1,1,1,0,18,0.00018
DontKillMe007,,,0,1,1,0,1,1,1,1,1,0,18,0.00018
Donwitoo1972,,,0,2,2,0,2,2,1,1,1,0,18,0.00018
ariyanjam70,,,1,0,1,1,0,1,0,0,0,0,18,0.000257
Doomanli1,,,0,1,1,0,1,1,1,1,1,0,142,0.00018
DoosteKhoobeMan,,,0,1,1,0,2,2,1,1,1,0,95,0.00018
Dorsa_moghadam,,,0,4,4,0,5,5,2,0.75,0.833333,0,95,0.00018
HZG1366,,,4,1,5,4,3,7,1,1,1,5,95,0.000405
Khi_Fighter,,,2,2,4,2,2,4,2,0.75,0.833333,4,95,0.00025
MostafaRezaee39,,,1,0,1,2,0,2,0,0,0,0,95,0.000219
Dpv8k2rKPddN9zh,,,0,6,6,0,11,11,2,0.714286,0.8,0,18,0.00018
DrAliReza14,,,0,1,1,0,2,2,1,1,1,0,48,0.00018
DrAtefehP,,,0,1,1,0,1,1,1,1,1,0,77,0.00018
DrAzad82463608,,,0,1,1,0,1,1,1,1,1,0,18,0.00018
DrFazlali,,,0,2,2,0,4,4,1,1,1,0,128,0.00018
HamzehMehrdad,,,1,0,1,2,0,2,0,0,0,0,128,0.000257
ar_moezi,,,1,0,1,2,0,2,0,0,0,0,128,0.000257
DrHitch9,,,0,1,1,0,1,1,1,1,1,0,18,0.00018
DrMsn89,,,0,1,1,0,4,4,1,1,1,0,77,0.00018
DrNamdar,,,0,1,1,0,2,2,1,1,1,0,129,0.00018
salar_seyf,,,1,0,1,2,0,2,0,0,0,0,129,0.000334
DrSaeedSattari,,,0,1,1,0,2,2,1,1,1,0,18,0.00018
DrTahlilgar,,,0,1,1,0,1,1,2,0.6,0.666667,0,18,0.00018
DrZarasvand,,,0,1,1,0,1,1,1,1,1,0,18,0.00018
Dr_Alef,,,0,1,1,0,2,2,1,1,1,0,18,0.00018
Dr_Barari,,,0,1,1,0,1,1,1,1,1,0,77,0.00018
Dr_Khalilinia,,,0,6,6,0,15,15,1,1,1,0,95,0.00018
FarsNews_Agency,,,3,0,3,3,0,3,0,0,0,0,95,0.000411
YASEEN1358,,,1,0,1,3,0,3,0,0,0,0,95,0.000206
hadikfn,,,2,0,2,7,0,7,0,0,0,0,95,0.000237
Dr_Shafaee,,,0,1,1,0,1,1,1,1,1,0,12,0.00018
Dr_kamalkhademi,,,0,1,1,0,1,1,1,1,1,0,95,0.00018
manofars,,,3,0,3,3,0,3,0,0,0,0,95,0.000499
Dr_m_khalili_93,,,0,4,4,0,9,9,1,1,1,0,95,0.00018
Dr_shderakhshan,,,0,1,1,0,2,2,1,1,1,0,95,0.00018
masoumebigdeli2,,,2,0,2,4,0,4,0,0,0,0,95,0.000356
Dr_solgi,,,1,1,2,4,4,8,0,0,0,0,130,0.00018
Drbab6,,,0,1,1,0,1,1,2,0.555556,0.6,0,18,0.00018
Drkakhal2018,,,0,1,1,0,1,1,1,1,1,0,18,0.00018
Drsocrates1996,,,0,1,1,0,2,2,1,1,1,0,95,0.00018
DsireClary,,,0,1,1,0,1,1,1,1,1,0,18,0.00018
DsmdiR,,,0,1,1,0,2,2,1,1,1,0,77,0.00018
DuffQajar2,,,0,1,1,0,4,4,1,1,1,0,95,0.00018
fateme_istadeh,,,2,0,2,7,0,7,0,0,0,0,95,0.000335
ECant0na,,,0,3,3,0,5,5,1,1,1,0,18,0.00018
mohammad_z_1992,,,1,0,1,1,0,1,0,0,0,0,77,0.00037
EHS95470211,,,0,1,1,0,1,1,1,1,1,0,18,0.00018
EI9zVYqIiTtan8d,,,0,1,1,0,1,1,1,1,1,0,95,0.00018
EKaffashi,,,0,1,1,0,2,2,1,1,1,0,131,0.00018
arabshahi_a,,,1,0,1,2,0,2,0,0,0,0,131,0.000334
EMojahedi,,,0,1,1,0,1,1,1,1,1,0,18,0.00018
ENZO__RAD,,,0,2,2,0,4,4,1,1,1,0,18,0.00018
EOo6SPAKuHprQjH,,,0,2,2,0,5,5,1,1,1,0,18,0.00018
EP_empirepersia,,,0,1,1,0,1,1,1,1,1,0,18,0.00018
EParvizi,,,0,1,1,0,1,1,1,1,1,0,132,0.00018
zenomek,,,2,0,2,2,0,2,0,0,0,0,132,0.000488
ERNestt_rpf,,,0,1,1,0,2,2,1,1,1,0,18,0.00018
ESFANDYAR_121,,,0,2,2,0,2,2,1,1,1,0,18,0.00018
ETthePsycho,,,0,1,1,0,1,1,1,1,1,0,77,0.00018
EZjkNR3wqAESfdp,,,0,1,1,0,1,1,1,1,1,0,18,0.00018
E_Mirzaahmadi,,,0,1,1,0,1,1,1,1,1,0,133,0.00018
h_maralani,,,1,0,1,1,0,1,0,0,0,0,133,0.000334
E_Porsan313,,,0,1,1,0,2,2,1,1,1,0,95,0.00018
Eba21265624,,,0,1,1,0,3,3,1,1,1,0,18,0.00018
EbiDiba,,,0,3,3,0,7,7,1,1,1,0,95,0.00018
abolfazllahmadi,,,2,0,2,3,0,3,0,0,0,0,95,0.000247
Ebii2000,,,0,2,2,0,3,3,1,1,1,0,18,0.00018
Ebn_Alahwaz1,,,0,1,1,0,1,1,1,1,1,0,12,0.00018
EbrahimAlef,,,0,1,1,0,1,1,1,1,1,0,18,0.00018
Ebrahimmhi,,,0,2,2,0,3,3,1,1,1,0,18,0.00018
EghlimaE,,,0,1,1,0,1,1,1,1,1,0,95,0.00018
Ehsan1135,,,0,1,1,0,1,1,1,1,1,0,95,0.00018
Ehsan4000,,,0,3,3,0,5,5,1,1,1,0,12,0.00018
manocherbi,,,3,0,3,3,0,3,0,0,0,0,12,0.00036
Ehsan585960,,,0,1,1,0,1,1,1,1,1,0,18,0.00018
iman_iran_2019,,,2,0,2,2,0,2,0,0,0,0,18,0.000373
Ehsan63944466,,,0,2,2,0,4,4,1,1,1,0,95,0.00018
Ehsan70647211,,,0,1,1,0,2,2,1,1,1,0,18,0.00018
Ehsan98677503,,,0,1,1,0,1,1,1,1,1,0,77,0.00018
EhsanBodaghi,,,0,2,2,0,2,2,1,1,1,0,77,0.00018
sadeq_hosseini,,,2,0,2,2,0,2,0,0,0,0,77,0.000411
EhsanRamezanian,,,0,1,1,0,2,2,1,1,1,0,134,0.00018
TirdadBonakdar,,,1,0,1,2,0,2,0,0,0,0,134,0.000334
EhsanTabakhian,,,0,1,1,0,1,1,1,1,1,0,77,0.00018
Ehsan_AMD72,,,0,1,1,0,1,1,1,1,1,0,18,0.00018
Ehsanbakhsh110,,,1,1,2,3,3,6,0,0,0,0,135,0.00018
Ehsani63,,,0,1,1,0,1,1,1,1,1,0,132,0.00018
EhsaniMaryam,,,0,1,1,0,1,1,1,1,1,0,77,0.00018
EightEmam,,,0,2,2,0,3,3,1,1,1,0,95,0.00018
EipYsJz84Lu1RAi,,,0,1,1,0,2,2,1,1,1,0,77,0.00018
EkhlasyVahid,,,0,4,4,0,5,5,2,0.75,0.833333,0,18,0.00018
Wimpak1,,,1,0,1,1,0,1,0,0,0,0,18,0.000232
unrecognizableN,,,1,0,1,1,0,1,0,0,0,0,18,0.000232
El_Dorado2015,,,0,3,3,0,4,4,1,1,1,0,18,0.00018
Elahe1379,,,0,1,1,0,1,1,1,1,1,0,18,0.00018
Elahe3355,,,0,1,1,0,2,2,1,1,1,0,95,0.00018
EldariHamid,,,0,1,1,0,4,4,3,0.478873,0.495098,0,95,0.00018
Gladiator400,,,1,29,30,4,50,54,2,0.891892,0.939394,33,95,0.000334
ElecLif,,,0,4,4,0,9,9,2,0.75,0.833333,0,18,0.00018
Radmehring,,,1,0,1,2,0,2,0,0,0,0,18,0.000219
dojhman,,,1,0,1,1,0,1,0,0,0,0,18,0.000219
Elen50488042,,,0,3,3,0,5,5,1,1,1,0,18,0.00018
Elesa_oland,,,0,5,5,0,14,14,3,0.555556,0.616667,0,18,0.00018
Elham74880522,,,0,1,1,0,1,1,1,1,1,0,77,0.00018
Elham97758775,,,0,1,1,0,1,1,1,1,1,0,18,0.00018
ElhamKhN,,,0,8,8,0,17,17,1,1,1,0,77,0.00018
IRAN40IRAN40,,,2,1,3,4,2,6,0,0,0,0,77,0.0002
OUnKnownnO,,,1,0,1,2,0,2,0,0,0,0,77,0.0002
Rahmandoost1,,,1,0,1,2,0,2,0,0,0,0,77,0.0002
ali313reza,,,1,0,1,2,0,2,0,0,0,0,77,0.0002
dnl_96_,,,2,0,2,4,0,4,0,0,0,0,77,0.000354
real_dr_b,,,1,0,1,2,0,2,0,0,0,0,77,0.0002
Elham_984,,,0,12,12,0,18,18,1,1,1,0,18,0.00018
ShafieiAbolfazl,,,2,0,2,4,0,4,0,0,0,0,18,0.000391
aghaee_nahangi,,,1,0,1,2,0,2,0,0,0,0,18,0.000193
ElhamiJavad,,,0,2,2,0,2,2,1,1,1,0,95,0.00018
Elhamkavaran,,,0,1,1,0,1,1,1,1,1,0,112,0.00018
Elhamnl,,,0,1,1,0,1,1,1,1,1,0,136,0.00018
Sushiansleader,,,1,0,1,1,0,1,0,0,0,0,136,0.000334
ElhamyIsaac,,,0,2,2,0,2,2,1,1,1,0,95,0.00018
parniann_artist,,,1,0,1,1,0,1,0,0,0,0,95,0.000257
Eli51257963,,,0,1,1,0,1,1,1,1,1,0,137,0.00018
MatinAlamian,,,1,0,1,1,0,1,0,0,0,0,137,0.000334
Eli94525713,,,0,5,5,0,13,13,2,0.857143,0.916667,0,18,0.00018
dr_jalali12,,,1,0,1,2,0,2,0,0,0,0,18,0.000211
Elihambaji,,,0,1,1,0,1,1,1,1,1,0,18,0.00018
Eliii79934888,,,0,1,1,0,2,2,1,1,1,0,18,0.00018
Elli194,,,0,1,1,0,1,1,1,1,1,0,138,0.00018
tiredbluesea,,,1,0,1,1,0,1,0,0,0,0,138,0.000334
ElnazSarvejahan,,,0,1,1,0,3,3,1,1,1,0,18,0.00018
Elnaz_1990,,,0,1,1,0,1,1,1,1,1,0,18,0.00018
Eltiam1001,,,1,3,4,1,6,7,1,1,1,4,95,0.000181
amarghkh,,,1,0,1,3,0,3,0,0,0,0,95,0.000232
EmadSiyfi,,,0,1,1,0,2,2,1,1,1,0,139,0.00018
Stardust1686,,,1,0,1,2,0,2,0,0,0,0,139,0.000334
Emadasadi10,,,0,3,3,0,3,3,1,1,1,0,95,0.00018
EmamiJalal,,,0,1,1,0,2,2,1,1,1,0,77,0.00018
EmanulSalvador,,,1,3,4,1,3,4,1,1,1,3,18,0.000232
Emen43054466,,,0,2,2,0,2,2,2,0.6,0.666667,0,18,0.00018
EmraanChohan,,,0,1,1,0,1,1,1,1,1,0,158,0.00018
Emruzz77,,,0,2,2,0,2,2,2,0.6,0.666667,0,18,0.00018
Enallah313,,,0,1,1,0,2,2,1,1,1,0,140,0.00018
xhxhxh114,,,1,0,1,2,0,2,0,0,0,0,140,0.000334
EngardeAmin,,,1,4,5,4,8,12,1,1,1,1,95,0.000219
elhamnazari4,,,1,0,1,1,0,1,0,0,0,0,95,0.000227
enghelabi_57,,,3,0,3,9,0,9,0,0,0,0,95,0.000267
EnghelabiDeymah,,,1,1,2,1,1,2,0,0,0,0,141,0.00018
EnghelabiDigar,,,1,1,2,1,2,3,1,1,1,1,77,0.000181
Enghlabi_am,,,0,26,26,0,47,47,2,0.964286,0.981481,0,95,0.00018
Maryam9464,,,1,0,1,3,0,3,0,0,0,0,95,0.000186
EnsanamArezoust,,,0,2,2,0,5,5,1,1,1,0,77,0.00018
EnsaneFani,,,0,1,1,0,1,1,2,0.666667,0.75,0,18,0.00018
Enschrodinger,,,0,1,1,0,1,1,1,1,1,0,112,0.00018
Entezar_312,,,0,1,1,0,2,2,1,1,1,0,95,0.00018
Entezar_ir,,,0,3,3,0,9,9,1,1,1,0,95,0.00018
Erfan23803369,,,0,1,1,0,1,1,1,1,1,0,77,0.00018
Erfan_and,,,0,1,1,0,2,2,1,1,1,0,77,0.00018
Erfane_314,,,0,5,5,0,18,18,1,1,1,0,95,0.00018
mohsen_mz1,,,1,0,1,2,0,2,0,0,0,0,95,0.000211
EricQ1204k,,,0,3,3,0,3,3,1,1,1,0,18,0.00018
EsfSaeid,,,0,1,1,0,1,1,1,1,1,0,77,0.00018
Eshaghi_,,,0,1,1,0,1,1,1,1,1,0,18,0.00018
Esharaat_eNazar,,,0,1,1,0,2,2,1,1,1,0,77,0.00018
Esii98866020,,,0,1,1,0,3,3,1,1,1,0,18,0.00018
Eslap_sh,,,0,1,1,0,1,1,1,1,1,0,77,0.00018
Eslayper,,,0,3,3,0,3,3,1,1,1,0,18,0.00018
keyvan72204,,,1,0,1,1,0,1,0,0,0,0,18,0.000232
EsmaeilJafari5,,,0,4,4,0,5,5,1,1,1,0,95,0.00018
baghermalaki,,,1,0,1,1,0,1,0,0,0,0,95,0.000219
hp_babak,,,5,0,5,9,0,9,0,0,0,0,95,0.000355
EsmailEslami,,,0,1,1,0,5,5,1,1,1,0,95,0.00018
EspeSchall,,,0,1,1,0,2,2,2,0.666667,0.75,0,18,0.00018
Esteghlal58,,,0,1,1,0,1,1,1,1,1,0,95,0.00018
Etesabi1414,,,0,1,1,0,1,1,1,1,1,0,95,0.00018
AbasiHanieh,,,2,0,2,2,0,2,0,0,0,0,95,0.000411
Etiol75,,,0,1,1,0,1,1,1,1,1,0,12,0.00018
EzSezar,,,0,1,1,0,2,2,1,1,1,0,77,0.00018
Eza_lor,,,0,1,1,0,2,2,1,1,1,0,85,0.00018
Ezzatoos,,,0,1,1,0,1,1,1,1,1,0,77,0.00018
F1r2i5,,,0,2,2,0,3,3,1,1,1,0,18,0.00018
AryoArsam,,,1,0,1,2,0,2,0,0,0,0,18,0.000257
FANOSS63,,,0,3,3,0,9,9,1,1,1,0,95,0.00018
ajVcBfLIrcxnVo7,,,1,0,1,2,0,2,0,0,0,0,95,0.000232
FARAMARZ11SABA,,,0,1,1,0,2,2,1,1,1,0,95,0.00018
FAli1969,,,0,3,3,0,10,10,1,1,1,0,18,0.00018
FBYXxjNOYBr3H6r,,,0,5,5,0,10,10,1,1,1,0,95,0.00018
MahdiBarazandeh,,,2,0,2,2,0,2,0,0,0,0,95,0.000212
digitaldost,,,1,0,1,2,0,2,0,0,0,0,95,0.000211
FCanaani,,,0,1,1,0,1,1,1,1,1,0,18,0.00018
FFhYL9TZ4IgYlYY,,,0,2,2,0,2,2,1,1,1,0,12,0.00018
kahkeshane_A,,,1,0,1,1,0,1,0,0,0,0,12,0.000257
FGhatan,,,0,6,6,0,12,12,1,1,1,0,18,0.00018
Parhami__,,,3,0,3,5,0,5,0,0,0,0,18,0.000222
FHarsej,,,0,1,1,0,2,2,1,1,1,0,95,0.00018
FJambor,,,0,2,2,0,2,2,2,0.666667,0.75,0,95,0.00018
FMxti,,,0,1,1,0,2,2,1,1,1,0,95,0.00018
FREE_IRAN_2018,,,0,2,2,0,3,3,1,1,1,0,18,0.00018
Siamak71480724,,,1,0,1,2,0,2,0,0,0,0,18,0.000257
FRezaei313,,,0,2,2,0,3,3,1,1,1,0,95,0.00018
fereydon_1400,,,1,0,1,1,0,1,0,0,0,0,95,0.000257
FSeifikaran,,,0,2,2,0,7,7,1,1,1,0,18,0.00018
FSp4895,,,0,1,1,0,1,1,1,1,1,0,95,0.00018
FTojali,,,0,1,1,0,2,2,2,0.666667,0.75,0,18,0.00018
FURE_BERHM,,,0,1,1,0,3,3,2,0.666667,0.75,0,18,0.00018
FVkY13272acD2Vr,,,0,3,3,0,3,3,1,1,1,0,95,0.00018
Yazdstar,,,3,0,3,3,0,3,0,0,0,0,95,0.000405
FZhrsdt,,,0,1,1,0,4,4,1,1,1,0,95,0.00018
F_AVATEFI68,,,0,20,20,0,65,65,1,1,1,0,95,0.00018
Bijan_sibil,,,2,0,2,4,0,4,0,0,0,0,95,0.000199
Hosein2020,,,1,0,1,2,0,2,0,0,0,0,95,0.000188
KheibariSaeed,,,1,0,1,2,0,2,0,0,0,0,95,0.000188
MortezaRohalami,,,2,0,2,4,0,4,0,0,0,0,95,0.000239
RahaValla,,,1,0,1,2,0,2,0,0,0,0,95,0.000188
ali_heidari9999,,,2,0,2,4,0,4,0,0,0,0,95,0.000199
baharbabam1,,,1,0,1,2,0,2,0,0,0,0,95,0.000188
elnasabori,,,2,0,2,6,0,6,0,0,0,0,95,0.000199
exir_7,,,2,0,2,6,0,6,0,0,0,0,95,0.000199
hastimaman,,,2,0,2,10,0,10,0,0,0,0,95,0.000199
hoosindoman,,,1,0,1,2,0,2,0,0,0,0,95,0.000188
miladkamali85,,,1,0,1,4,0,4,0,0,0,0,95,0.000188
nilofarabii,,,1,0,1,2,0,2,0,0,0,0,95,0.000188
sanaz_1234,,,1,0,1,17,0,17,0,0,0,0,95,0.000188
solymani1405,,,1,0,1,2,0,2,0,0,0,0,95,0.000188
F_MAJAZI,,,0,2,2,0,3,3,1,1,1,0,142,0.00018
noorieh_v,,,1,0,1,2,0,2,0,0,0,0,142,0.000257
F_mollazadeh,,,0,1,1,0,2,2,1,1,1,0,95,0.00018
Fa_Shayesteh,,,0,1,1,0,1,1,1,1,1,0,77,0.00018
Fa_Wahaj,,,0,10,10,0,18,18,2,0.708333,0.794118,0,95,0.00018
Banu1375,,,1,0,1,3,0,3,0,0,0,0,95,0.000196
Graph_khan,,,1,3,4,2,5,7,1,1,1,3,95,0.000196
a_taghii,,,3,0,3,4,0,4,0,0,0,0,95,0.00025
naeeme59,,,1,0,1,2,0,2,0,0,0,0,95,0.000196
Faa916,,,0,1,1,0,1,1,1,1,1,0,18,0.00018
FaatemeM,,,0,1,1,0,1,1,1,1,1,0,77,0.00018
Faeze812,,,0,1,1,0,1,1,1,1,1,0,143,0.00018
mojde40340789,,,1,0,1,1,0,1,0,0,0,0,143,0.000334
Faeze_sb,,,0,4,4,0,7,7,1,1,1,0,95,0.00018
Mbt2019,,,1,0,1,1,0,1,0,0,0,0,95,0.000219
Faezeh199710,,,0,3,3,0,6,6,1,1,1,0,95,0.00018
Fafaloos,,,0,1,1,0,1,1,1,1,1,0,18,0.00018
FaghBoland,,,0,2,2,0,3,3,2,0.6,0.666667,0,18,0.00018
FaghanAzBidad,,,0,1,1,0,1,1,1,1,1,0,144,0.00018
Mahshid_Samei,,,1,0,1,1,0,1,0,0,0,0,144,0.000334
FaghihiSajjad,,,0,1,1,0,3,3,1,1,1,0,95,0.00018
Fahim0035,,,0,1,1,0,1,1,1,1,1,0,95,0.00018
FahimeRaj,,,0,1,1,0,1,1,1,1,1,0,77,0.00018
Fahime_paeez,,,0,1,1,0,1,1,1,1,1,0,77,0.00018
Fahimeh20173,,,0,1,1,0,3,3,1,1,1,0,95,0.00018
Fahimeh21741472,,,0,1,1,0,1,1,1,1,1,0,145,0.00018
NCRI_Supporters,,,1,0,1,1,0,1,0,0,0,0,145,0.000334
Fahimehb2,,,0,1,1,0,2,2,1,1,1,0,146,0.00018
samedoun,,,1,0,1,2,0,2,0,0,0,0,146,0.000334
Fakhr__Mohammad,,,0,2,2,0,2,2,1,1,1,0,95,0.00018
Fakhteh_88,,,0,1,1,0,1,1,1,1,1,0,77,0.00018
Fakhteo,,,0,1,1,0,1,1,1,1,1,0,147,0.00018
Falcon70228846,,,0,4,4,0,9,9,1,1,1,0,18,0.00018
helen_nour,,,1,0,1,1,0,1,0,0,0,0,18,0.000219
FalconCzf,,,0,1,1,0,1,1,1,1,1,0,18,0.00018
Fano0o301,,,1,3,4,1,3,4,1,1,1,0,95,0.00018
Fanoos_313,,,0,1,1,0,4,4,1,1,1,0,148,0.00018
velayat058,,,1,0,1,4,0,4,0,0,0,0,148,0.000334
FarNam31185003,,,0,3,3,0,3,3,1,1,1,0,12,0.00018
FarahaniReports,,,1,1,2,2,2,4,1,1,1,1,77,0.000334
mehdikr1986,,,2,0,2,4,0,4,0,0,0,0,77,0.000544
FarahmandHanie,,,0,1,1,0,1,1,1,1,1,0,95,0.00018
FarahmandVa,,,0,12,12,0,24,24,2,0.772727,0.852941,0,95,0.00018
hasanafkar,,,1,0,1,2,0,2,0,0,0,0,95,0.000193
mehdi_tfi,,,1,0,1,2,0,2,0,0,0,0,95,0.000193
mostafaasadi73,,,1,0,1,2,0,2,0,0,0,0,95,0.000193
Farahmand_Mohse,,,0,1,1,0,4,4,1,1,1,0,18,0.00018
Farahzad10,,,0,1,1,0,1,1,1,1,1,0,18,0.00018
FarahzadFarzad,,,0,29,29,0,44,44,4,0.56044,0.727124,0,18,0.00018
Utfryst_,,,1,0,1,1,0,1,0,0,0,0,18,0.000186
VOAIran,,,1,0,1,1,0,1,0,0,0,0,18,0.000186
mehrdad_1996o,,,1,0,1,2,0,2,0,0,0,0,18,0.000186
seda1995555,,,1,0,1,3,0,3,0,0,0,0,18,0.000186
FaramarzEEE,,,0,4,4,0,12,12,1,1,1,0,18,0.00018
_Sheina__,,,3,0,3,7,0,7,0,0,0,0,18,0.000327
Faranak_amidi,,,0,1,1,0,1,1,1,1,1,0,77,0.00018
Farbodmv,,,0,1,1,0,2,2,1,1,1,0,77,0.00018
Fardintala1,,,0,2,2,0,3,3,1,1,1,0,18,0.00018
ROYAL_IR,,,1,0,1,1,0,1,0,0,0,0,18,0.000257
Fareydunfarrokh,,,0,1,1,0,2,2,1,1,1,0,18,0.00018
Farhad98725376,,,0,5,5,0,8,8,2,0.6,0.666667,0,18,0.00018
Farhad_SD,,,0,1,1,0,1,1,1,1,1,0,18,0.00018
Farhadf81223000,,,0,10,10,0,18,18,5,0.319372,0.418852,0,18,0.00018
artemisbano,,,3,0,3,6,0,6,0,0,0,0,18,0.00029
mehrdad68071661,,,1,0,1,1,0,1,0,0,0,0,18,0.000196
Farhan_kaa,,,0,2,2,0,4,4,1,1,1,0,95,0.00018
FaribaJavdani,,,0,2,2,0,3,3,1,1,1,0,77,0.00018
FaribaRadmehr,,,0,1,1,0,2,2,1,1,1,0,149,0.00018
EhsanPersian1,,,1,0,1,2,0,2,0,0,0,0,149,0.000334
FaridJavani,,,0,1,1,0,4,4,1,1,1,0,18,0.00018
FaridMoafg,,,0,1,1,0,3,3,1,1,1,0,95,0.00018
Farideh110,,,0,3,3,0,5,5,1,1,1,0,95,0.00018
FaridheVakili,,,0,1,1,0,1,1,1,1,1,0,77,0.00018
FarimaFard,,,0,4,4,0,5,5,1,1,1,0,12,0.00018
besoyepirozi,,,1,0,1,2,0,2,0,0,0,0,12,0.000219
iranazadi1395,,,1,0,1,1,0,1,0,0,0,0,12,0.000219
Farmande274,,,0,1,1,0,2,2,1,1,1,0,95,0.00018
Farmandeh_koL,,,0,3,3,0,6,6,1,1,1,0,95,0.00018
FarnAba,,,1,2,3,2,4,6,1,1,1,0,77,0.00018
FarnazML64,,,0,1,1,0,1,1,1,1,1,0,18,0.00018
mahenoghree,,,2,0,2,5,0,5,0,0,0,0,18,0.000237
Farokhzad_57,,,0,1,1,0,1,1,1,1,1,0,18,0.00018
FarsKhz,,,0,1,1,0,1,1,1,1,1,0,95,0.00018
Fars_Plus,,,0,1,1,0,2,2,1,1,1,0,64,0.00018
Farshadm11,,,0,1,1,0,2,2,1,1,1,0,77,0.00018
Farshadpashaei,,,0,10,10,0,19,19,3,0.466019,0.545139,0,95,0.00018
FarshbafJahani,,,0,4,4,0,10,10,1,1,1,0,18,0.00018
Farshid47343199,,,0,1,1,0,1,1,1,1,1,0,95,0.00018
Farshid7780,,,0,1,1,0,1,1,1,1,1,0,95,0.00018
FarshidF10,,,0,3,3,0,3,3,1,1,1,0,12,0.00018
IranianForum,,,4,0,4,4,0,4,0,0,0,0,12,0.000591
Farveh00,,,0,1,1,0,2,2,1,1,1,0,77,0.00018
Faryad101,,,0,2,2,0,3,3,1,1,1,0,12,0.00018
Faryad24843913,,,0,9,9,0,12,12,3,0.595238,0.673333,0,18,0.00018
Vahomane,,,1,0,1,1,0,1,0,0,0,0,18,0.000198
Faryad61814840,,,0,5,5,0,8,8,5,0.299492,0.362429,0,18,0.00018
barca8888,,,2,0,2,2,0,2,0,0,0,0,18,0.000233
kourosh_1974,,,1,0,1,1,0,1,0,0,0,0,18,0.000211
Faryad_har,,,0,2,2,0,4,4,1,1,1,0,18,0.00018
Faryadepersia,,,0,1,1,0,3,3,1,1,1,0,18,0.00018
FarzSaeidi,,,0,3,3,0,4,4,1,1,1,0,18,0.00018
Farzad13931,,,0,4,4,0,10,10,2,0.833333,0.9,0,18,0.00018
Farzad2425,,,0,1,1,0,2,2,1,1,1,0,18,0.00018
FarzadForPeace,,,0,2,2,0,2,2,1,1,1,0,77,0.00018
FarzanShahram,,,0,1,1,0,2,2,1,1,1,0,18,0.00018
Farzan_aria,,,0,2,2,0,3,3,1,1,1,0,18,0.00018
Farzane53395650,,,0,1,1,0,1,1,1,1,1,0,12,0.00018
Farzane7377,,,0,2,2,0,3,3,1,1,1,0,18,0.00018
Farzanehyaz,,,0,1,1,0,1,1,1,1,1,0,12,0.00018
FarzinPishro,,,0,1,1,0,1,1,1,1,1,0,18,0.00018
Fataneh49460550,,,0,2,2,0,4,4,1,1,1,0,18,0.00018
Fateemeehh,,,0,2,2,0,4,4,1,1,1,0,77,0.00018
Arman_Truth,,,1,0,1,2,0,2,0,0,0,0,77,0.000257
Fateme31748027,,,0,1,1,0,1,1,1,1,1,0,150,0.00018
MSMJFR1358,,,1,0,1,1,0,1,0,0,0,0,150,0.000334
Fateme525,,,0,5,5,0,8,8,1,1,1,0,95,0.00018
Milad_Karami866,,,3,0,3,3,0,3,0,0,0,0,95,0.000216
fatemehsadat699,,,3,0,3,3,0,3,0,0,0,0,95,0.000216
raisit1391,,,2,0,2,2,0,2,0,0,0,0,95,0.000219
tafresh_ma,,,2,0,2,4,0,4,0,0,0,0,95,0.000221
Fateme6869,,,0,1,1,0,2,2,1,1,1,0,151,0.00018
gollabetoon,,,1,0,1,2,0,2,0,0,0,0,151,0.000334
FatemeSadat_m,,,0,1,1,0,2,2,1,1,1,0,95,0.00018
FatemeZamane,,,0,1,1,0,1,1,1,1,1,0,95,0.00018
FatemeZz,,,0,1,1,0,1,1,2,0.666667,0.75,0,152,0.00018
Herr_Nii,,,1,1,2,1,1,2,1,1,1,1,152,0.000334
Fateme_77_,,,0,2,2,0,4,4,1,1,1,0,95,0.00018
Fateme_rp74,,,0,1,1,0,1,1,1,1,1,0,153,0.00018
mysamcivil,,,1,0,1,1,0,1,0,0,0,0,153,0.000334
Fatemeh0_0,,,0,1,1,0,1,1,2,0.666667,0.75,0,18,0.00018
Fatemeh13220814,,,0,1,1,0,1,1,1,1,1,0,77,0.00018
1992Khadem,,,2,0,2,4,0,4,0,0,0,0,95,0.000191
Hodaei20,,,2,3,5,4,7,11,1,1,1,9,95,0.000265
MoradiRadmehr76,,,1,0,1,2,0,2,0,0,0,0,95,0.000188
Resaneim,,,2,0,2,4,0,4,0,0,0,0,95,0.000191
barana202,,,2,0,2,6,0,6,0,0,0,0,95,0.000227
firouzbakht_h,,,2,0,2,4,0,4,0,0,0,0,95,0.000191
hossein313_m,,,1,0,1,2,0,2,0,0,0,0,95,0.000188
misagh13653,,,2,0,2,4,0,4,0,0,0,0,95,0.000227
morteza_binesh,,,1,0,1,2,0,2,0,0,0,0,95,0.000188
sarzaeim,,,2,0,2,4,0,4,0,0,0,0,95,0.000227
shahidyyyy,,,2,0,2,4,0,4,0,0,0,0,95,0.000342
topolof_kh,,,3,0,3,3,0,3,0,0,0,0,95,0.000192
Fatemeh92439147,,,0,1,1,0,2,2,1,1,1,0,77,0.00018
FatemehAlizad19,,,0,2,2,0,2,2,1,1,1,0,12,0.00018
FatemehBanu,,,0,1,1,0,2,2,1,1,1,0,154,0.00018
masomeh_i,,,2,0,2,4,0,4,0,0,0,0,154,0.000488
FatemehZeinali1,,,0,6,6,0,8,8,1,1,1,0,95,0.00018
Mpourkhiabi,,,2,0,2,2,0,2,0,0,0,0,95,0.000209
Shabgardtanhaaa,,,4,0,4,9,0,9,0,0,0,0,95,0.000264
aq_Roham,,,1,0,1,1,0,1,0,0,0,0,95,0.000206
Fatemeh_Nezhad,,,0,4,4,0,5,5,1,1,1,0,95,0.00018
Fatemeh__1368,,,0,1,1,0,2,2,1,1,1,0,95,0.00018
Fatemeh_a722,,,0,8,8,0,16,16,1,1,1,0,95,0.00018
m_mirsaraei,,,2,0,2,2,0,2,0,0,0,0,95,0.000203
Fatemeh_shki,,,0,1,1,0,1,1,1,1,1,0,155,0.00018
Alrza4444,,,1,0,1,1,0,1,0,0,0,0,155,0.000334
Fatemehbanoo5,,,2,2,4,14,2,16,2,0.555556,0.6,20,95,0.000184
Fattahi_7,,,1,4,5,1,4,5,2,0.642857,0.722222,10,95,0.000259
FatemhGholami,,,0,2,2,0,3,3,1,1,1,0,95,0.00018
abdanan97,,,1,0,1,2,0,2,0,0,0,0,95,0.000257
khat_moghadam,,,3,0,3,5,0,5,0,0,0,0,95,0.000291
FatemiFa,,,0,1,1,0,1,1,1,1,1,0,95,0.00018
Fatiima_76,,,0,1,1,0,1,1,1,1,1,0,9,0.00018
banoyehjonoob,,,1,0,1,4,0,4,0,0,0,0,95,0.000197
zahra_salam313,,,2,0,2,6,0,6,0,0,0,0,95,0.000203
Fatima3769,,,0,10,10,0,31,31,1,1,1,0,95,0.00018
mahdi_zeinaliz,,,3,0,3,8,0,8,0,0,0,0,95,0.000239
miss_enghlabi,,,1,0,1,1,0,1,0,0,0,0,95,0.000236
Fazakker88,,,0,3,3,0,5,5,1,1,1,0,77,0.00018
Siavoo,,,1,0,1,2,0,2,0,0,0,0,77,0.000232
sunpadh,,,1,0,1,2,0,2,0,0,0,0,77,0.000232
FazalNaveed4,,,0,1,1,0,1,1,1,1,1,0,158,0.00018
FazanehK,,,0,1,1,0,2,2,1,1,1,0,77,0.00018
Fcbarca22276662,,,0,4,4,0,7,7,2,0.7,0.785714,0,95,0.00018
FeR_OwN,,,0,1,1,0,1,1,2,0.555556,0.6,0,18,0.00018
Feelnejad,,,0,1,1,0,1,1,1,1,1,0,18,0.00018
Feloneee,,,0,1,1,0,1,1,1,1,1,0,77,0.00018
Felunishun,,,0,1,1,0,2,2,1,1,1,0,77,0.00018
Ferdinand2345,,,0,3,3,0,7,7,1,1,1,0,18,0.00018
Roshanackk,,,4,0,4,6,0,6,0,0,0,0,18,0.000278
FerdosiMeysam,,,0,1,1,0,2,2,1,1,1,0,18,0.00018
Ferizsh,,,0,1,1,0,1,1,1,1,1,0,18,0.00018
FgTamana,,,0,1,1,0,3,3,1,1,1,0,156,0.00018
sajjad_h71,,,1,0,1,3,0,3,0,0,0,0,156,0.000334
FifiRezaei,,,0,3,3,0,3,3,1,1,1,0,28,0.00018
MAbarghoo,,,1,0,1,1,0,1,0,0,0,0,28,0.000232
Solfamiredosila,,,1,0,1,1,0,1,0,0,0,0,28,0.000232
Fighter12345k,,,0,4,4,0,4,4,2,0.583333,0.642857,0,18,0.00018
Mr_m5383,,,1,0,1,1,0,1,0,0,0,0,18,0.000219
FirstHAMAN1,,,0,1,1,0,1,1,1,1,1,0,77,0.00018
Firufree,,,0,1,1,0,1,1,1,1,1,0,157,0.00018
pesar_bad1,,,1,0,1,1,0,1,0,0,0,0,157,0.000334
Fivelight5,,,0,2,2,0,3,3,2,0.75,0.833333,0,95,0.00018
FizaChaudhry4,,,0,1,1,0,2,2,1,1,1,0,158,0.00018
FlokiFloki2018,,,0,2,2,0,2,2,1,1,1,0,18,0.00018
Flubird3,,,0,5,5,0,5,5,2,0.857143,0.916667,0,18,0.00018
Tiredgnats,,,1,0,1,1,0,1,0,0,0,0,18,0.000211
raiseirann,,,1,0,1,1,0,1,0,0,0,0,18,0.000211
FlunFlander,,,0,1,1,0,1,1,2,0.666667,0.75,0,18,0.00018
FlyingPoet,,,0,1,1,0,1,1,1,1,1,0,18,0.00018
FnVVN4ZgU5q45kE,,,0,1,1,0,2,2,1,1,1,0,18,0.00018
FoadFarahani,,,0,1,1,0,2,2,1,1,1,0,77,0.00018
ForghanyMohsen,,,1,1,2,1,1,2,0,0,0,0,159,0.00018
ForneverFlower,,,0,1,1,0,1,1,1,1,1,0,77,0.00018
ForuzAhmadii,,,0,2,2,0,3,3,1,1,1,0,18,0.00018
FoxNews_Chanel,,,0,1,1,0,4,4,1,1,1,0,18,0.00018
FpVIhT8dkdXBcrN,,,0,2,2,0,2,2,1,1,1,0,160,0.00018
R__challenge,,,1,0,1,1,0,1,0,0,0,0,160,0.000257
arsh7r65,,,1,0,1,1,0,1,0,0,0,0,160,0.000257
FranFrancoBaham,,,0,1,1,0,1,1,1,1,1,0,18,0.00018
FrauleinZara,,,0,1,1,0,1,1,1,1,1,0,18,0.00018
FrdiMorchesiy13,,,0,3,3,0,4,4,2,0.8,0.875,0,18,0.00018
Fred64552049,,,0,1,1,0,1,1,1,1,1,0,18,0.00018
Fred__eng,,,0,1,1,0,2,2,1,1,1,0,95,0.00018
Fredroshanravan,,,0,3,3,0,4,4,1,1,1,0,18,0.00018
FreeIra67433103,,,0,1,1,0,1,1,6,0.239382,0.277419,0,18,0.00018
Freedom14293107,,,1,12,13,6,25,31,5,0.331683,0.439801,67,18,0.000232
alireza19850,,,1,0,1,1,0,1,0,0,0,0,18,0.000197
Freedom88059345,,,0,1,1,0,1,1,1,1,1,0,161,0.00018
LetinThaaib,,,1,0,1,1,0,1,0,0,0,0,161,0.000334
FreedomHamid,,,0,1,1,0,1,1,1,1,1,0,18,0.00018
FreedomMohamadi,,,0,1,1,0,1,1,1,1,1,0,12,0.00018
Freedomexpres13,,,0,1,1,0,1,1,1,1,1,0,12,0.00018
Freedomm_451,,,0,2,2,0,2,2,1,1,1,0,18,0.00018
Freeiran_Sam,,,0,1,1,0,2,2,1,1,1,0,18,0.00018
Friedrich_555,,,0,2,2,0,2,2,1,1,1,0,18,0.00018
FriendsFreeIran,,,0,1,1,0,1,1,1,1,1,0,12,0.00018
Fringe_love,,,0,12,12,0,19,19,3,0.54878,0.618519,0,18,0.00018
Herwak2578,,,1,0,1,1,0,1,0,0,0,0,18,0.000193
KonourSharar,,,2,0,2,2,0,2,0,0,0,0,18,0.000232
P97YFOwdM5hs5ak,,,1,0,1,1,0,1,0,0,0,0,18,0.000193
Frsht_amini,,,0,2,2,0,2,2,1,1,1,0,3,0.00018
ghallash,,,1,0,1,1,0,1,0,0,0,0,3,0.000257
Frzi_Me,,,0,2,2,0,2,2,1,1,1,0,18,0.00018
Fs61073619,,,0,15,15,0,30,30,1,1,1,0,95,0.00018
AliTiam,,,1,0,1,2,0,2,0,0,0,0,95,0.000191
seyedporia,,,1,0,1,1,0,1,0,0,0,0,95,0.000191
shabnamha1,,,3,0,3,8,0,8,0,0,0,0,95,0.000253
Fs_Bokaei,,,0,1,1,0,2,2,1,1,1,0,162,0.00018
sayed92amin,,,2,0,2,4,0,4,0,0,0,0,162,0.000488
FsmTabatabai,,,0,1,1,0,2,2,1,1,1,0,163,0.00018
taroo_1400,,,1,0,1,2,0,2,0,0,0,0,163,0.000334
FtmB02,,,1,1,2,1,1,2,0,0,0,0,164,0.00018
FtmZare,,,0,1,1,0,2,2,1,1,1,0,165,0.00018
Mohsenghafory,,,1,0,1,2,0,2,0,0,0,0,165,0.000334
Ftm_Zmni,,,0,1,1,0,3,3,1,1,1,0,166,0.00018
zeynabzadeh,,,1,0,1,3,0,3,0,0,0,0,166,0.000334
FuegoAT,,,0,1,1,0,1,1,1,1,1,0,18,0.00018
FunnyFox12,,,0,1,1,0,1,1,1,1,1,0,77,0.00018
Future_enginer7,,,0,3,3,0,5,5,1,1,1,0,95,0.00018
Fygarow,,,0,2,2,0,2,2,1,1,1,0,18,0.00018
G4uGq0Wronw9cMP,,,0,1,1,0,1,1,1,1,1,0,18,0.00018
GA8q8wI9xetxXxN,,,0,1,1,0,1,1,1,1,1,0,95,0.00018
GDowom,,,0,2,2,0,9,9,1,1,1,0,95,0.00018
GFakhari,,,0,1,1,0,2,2,1,1,1,0,18,0.00018
GGheis,,,0,1,1,0,3,3,2,0.6,0.666667,0,77,0.00018
GhoreishiG,,,1,2,3,3,2,5,1,1,1,2,77,0.000334
GN_Ejghm,,,0,1,1,0,1,1,1,1,1,0,167,0.00018
hirooo021,,,1,0,1,1,0,1,0,0,0,0,167,0.000334
GODISLO44048942,,,0,1,1,0,1,1,1,1,1,0,4,0.00018
G_Sigmund_Freud,,,0,1,1,0,2,2,1,1,1,0,18,0.00018
G_graphicm,,,0,1,1,0,1,1,1,1,1,0,95,0.00018
G_telephonchi,,,0,1,1,0,2,2,1,1,1,0,168,0.00018
Mim__jim2,,,1,0,1,2,0,2,0,0,0,0,168,0.000334
atipasebani,,,1,0,1,3,0,3,0,0,0,0,95,0.000221
Gandom77,,,0,2,2,0,2,2,1,1,1,0,18,0.00018
Gandomfa,,,0,6,6,0,15,15,1,1,1,0,95,0.00018
Gazellera,,,0,1,1,0,2,2,1,1,1,0,18,0.00018
Gelmocheh,,,0,3,3,0,3,3,1,1,1,0,18,0.00018
1000pa2,,,1,0,1,1,0,1,0,0,0,0,18,0.000232
GenuinIRANian,,,0,2,2,0,3,3,2,0.625,0.7,0,18,0.00018
Gerduo,,,0,1,1,0,1,1,1,1,1,0,77,0.00018
Geremlin,,,0,1,1,0,1,1,1,1,1,0,18,0.00018
tired_phantom,,,2,0,2,2,0,2,0,0,0,0,18,0.000386
GhadimiMehdi,,,0,1,1,0,1,1,1,1,1,0,169,0.00018
BabiMirzaa,,,1,0,1,1,0,1,0,0,0,0,169,0.000334
GhaediB,,,0,5,5,0,5,5,2,0.857143,0.916667,0,18,0.00018
hich_betavan_n,,,1,0,1,1,0,1,0,0,0,0,18,0.000211
paradoxxxx467,,,1,0,1,1,0,1,0,0,0,0,18,0.000211
GhaediH,,,0,1,1,0,1,1,1,1,1,0,18,0.00018
GhaediHossin,,,0,3,3,0,3,3,1,1,1,0,95,0.00018
Ghaem71174906,,,0,1,1,0,1,1,2,0.666667,0.75,0,95,0.00018
GhaeniMohaan,,,0,1,1,0,2,2,1,1,1,0,95,0.00018
GhahrmanA,,,0,1,1,0,2,2,1,1,1,0,95,0.00018
Ghalam02225368,,,0,1,1,0,1,1,1,1,1,0,95,0.00018
Ghalbe_Yakhi_,,,0,2,2,0,6,6,1,1,1,0,95,0.00018
GhanbariradM,,,0,4,4,0,6,6,2,0.642857,0.722222,0,18,0.00018
GhasemVafaie,,,0,1,1,0,2,2,1,1,1,0,95,0.00018
Ghasemmohamma18,,,0,1,1,0,1,1,1,1,1,0,95,0.00018
Ghazalibanoo,,,0,1,1,0,1,1,1,1,1,0,77,0.00018
GhaziSadeghi,,,0,1,1,0,1,1,1,1,1,0,12,0.00018
GheisariMehdi,,,0,1,1,0,1,1,1,1,1,0,95,0.00018
GhermezRoz,,,0,1,1,0,1,1,1,1,1,0,95,0.00018
Ghobadi1993,,,0,1,1,0,2,2,1,1,1,0,95,0.00018
Ghoghnus11,,,0,4,4,0,8,8,1,1,1,0,95,0.00018
Gholam46609330,,,0,1,1,0,1,1,1,1,1,0,77,0.00018
GholamaliNiazi,,,0,1,1,0,1,1,1,1,1,0,95,0.00018
GholipourAr,,,0,3,3,0,3,3,1,1,1,0,95,0.00018
Ghomnam313,,,1,14,15,2,27,29,1,1,1,0,95,0.00018
Ehsan3136969,,,1,0,1,2,0,2,0,0,0,0,95,0.000191
shd_dehghan_741,,,1,0,1,2,0,2,0,0,0,0,95,0.000191
Ghuordie,,,0,1,1,0,1,1,1,1,1,0,170,0.00018
RKoloft,,,1,0,1,1,0,1,0,0,0,0,170,0.000334
Gidibamoidi,,,0,1,1,0,1,1,1,1,1,0,18,0.00018
Giigantiism,,,0,1,1,0,1,1,1,1,1,0,18,0.00018
Giij97,,,0,1,1,0,1,1,1,1,1,0,18,0.00018
Gildokht13,,,0,3,3,0,5,5,1,1,1,0,95,0.00018
azad9271,,,1,0,1,1,0,1,0,0,0,0,95,0.000232
GillanYar,,,0,1,1,0,1,1,1,1,1,0,171,0.00018
eshghdoostt,,,1,0,1,1,0,1,0,0,0,0,171,0.000334
Gimli_3434,,,0,1,1,0,1,1,1,1,1,0,18,0.00018
Girlak_,,,0,1,1,0,2,2,1,1,1,0,95,0.00018
Gisele44558675,,,0,1,1,0,1,1,1,1,1,0,77,0.00018
GisooBarazande,,,0,1,1,0,2,2,2,0.666667,0.75,0,95,0.00018
Gisso13,,,0,10,10,0,15,15,3,0.615385,0.701389,0,18,0.00018
Benyamin_ghavam,,,1,0,1,1,0,1,0,0,0,0,95,0.00019
Hoghooghdan97,,,2,2,4,3,3,6,1,1,1,4,95,0.000344
R_hajavi1,,,1,0,1,2,0,2,0,0,0,0,95,0.00019
dr_biarjomandi,,,1,0,1,2,0,2,0,0,0,0,95,0.00019
sadathosseini1,,,1,0,1,1,0,1,0,0,0,0,95,0.00019
sheykh_mammad1,,,1,0,1,2,0,2,0,0,0,0,95,0.00019
Gllottis,,,0,1,1,0,1,1,1,1,1,0,18,0.00018
Global_Viewer,,,0,1,1,0,1,1,1,1,1,0,18,0.00018
Gn85Nazanin,,,0,2,2,0,3,3,2,0.6,0.666667,0,77,0.00018
GnWthThWnd,,,0,1,1,0,1,1,1,1,1,0,77,0.00018
GoZ590ElztdKefF,,,0,2,2,0,3,3,1,1,1,0,95,0.00018
Goftaniha,,,0,1,1,0,2,2,1,1,1,0,172,0.00018
irbriefing,,,1,0,1,2,0,2,0,0,0,0,172,0.000334
Golchehre5,,,0,10,10,0,20,20,1,1,1,0,95,0.00018
s_isatahmasby,,,1,0,1,3,0,3,0,0,0,0,95,0.000196
Golden1282,,,0,4,4,0,5,5,1,1,1,0,18,0.00018
fuolak,,,1,0,1,1,0,1,0,0,0,0,18,0.000219
Gole_Yaakh,,,0,1,1,0,6,6,1,1,1,0,173,0.00018
Soltaan313,,,1,0,1,6,0,6,0,0,0,0,173,0.000334
Goli245,,,0,2,2,0,4,4,1,1,1,0,77,0.00018
Goligolgolii,,,0,1,1,0,1,1,1,1,1,0,77,0.00018
GolitaHosseinP1,,,0,1,1,0,4,4,1,1,1,0,18,0.00018
Golzare_shohada,,,0,2,2,0,4,4,1,1,1,0,95,0.00018
Gomnam112,,,0,1,1,0,3,3,2,0.666667,0.75,0,95,0.00018
jafarioooo,,,1,0,1,2,0,2,0,0,0,0,95,0.000206
mhalipoor1,,,1,0,1,3,0,3,0,0,0,0,95,0.000206
Gomnam_IR_,,,0,1,1,0,1,1,1,1,1,0,174,0.00018
Rohollaah,,,1,0,1,1,0,1,0,0,0,0,174,0.000334
GoodCartoon_ir,,,0,2,2,0,3,3,1,1,1,0,95,0.00018
Good_Bad_Ugly__,,,0,1,1,0,2,2,1,1,1,0,18,0.00018
Goodmind1234,,,0,1,1,0,1,1,1,1,1,0,175,0.00018
hafezshyrazi,,,1,0,1,1,0,1,0,0,0,0,175,0.000334
GoofyHerman,,,0,1,1,0,1,1,1,1,1,0,18,0.00018
Goolrooz1,,,0,2,2,0,4,4,1,1,1,0,95,0.00018
Goraz_23,,,0,1,1,0,1,1,1,1,1,0,176,0.00018
aldiakomid,,,1,0,1,1,0,1,0,0,0,0,176,0.000334
Gordan_shahadat,,,0,1,1,0,4,4,1,1,1,0,177,0.00018
tavabin,,,1,0,1,4,0,4,0,0,0,0,177,0.000334
GostarHagh,,,0,1,1,0,1,1,1,1,1,0,178,0.00018
just_boy2080,,,1,0,1,1,0,1,0,0,0,0,178,0.000334
Gr8talkative,,,0,1,1,0,2,2,1,1,1,0,77,0.00018
GrayFunction,,,0,4,4,0,5,5,1,1,1,0,18,0.00018
GrayGandalf_RG,,,0,1,1,0,2,2,1,1,1,0,18,0.00018
Gray_Mind75,,,0,1,1,0,1,1,1,1,1,0,18,0.00018
GreatWesen,,,0,1,1,0,1,1,1,1,1,0,18,0.00018
Great_Programer,,,0,1,1,0,2,2,1,1,1,0,95,0.00018
Greaterdead,,,0,4,4,0,6,6,1,1,1,0,95,0.00018
Green_Cinelit,,,0,3,3,0,4,4,1,1,1,0,77,0.00018
mimnevesht,,,1,0,1,1,0,1,0,0,0,0,77,0.000232
Green_Fenugreek,,,0,1,1,0,2,2,1,1,1,0,18,0.00018
Greenflags12,,,2,48,50,4,91,95,2,0.873016,0.927273,78.5,95,0.000185
Amirhosein_AHF,,,1,0,1,1,0,1,0,0,0,0,95,0.000184
Naser06082027,,,1,0,1,3,0,3,0,0,0,0,95,0.000184
Rezameymanat,,,1,0,1,1,0,1,0,0,0,0,95,0.000184
VahidProg,,,1,0,1,3,0,3,0,0,0,0,95,0.000184
m_fouladyan,,,1,0,1,3,0,3,0,0,0,0,95,0.000184
mojiahmadi_,,,1,0,1,1,0,1,0,0,0,0,95,0.000184
mossis75,,,1,0,1,3,0,3,0,0,0,0,95,0.000184
nakhodkh,,,1,0,1,3,0,3,0,0,0,0,95,0.000184
negaraneto,,,1,0,1,3,0,3,0,0,0,0,95,0.000184
safdarzade,,,1,0,1,1,0,1,0,0,0,0,95,0.000184
Group_ILSG,,,0,1,1,0,2,2,1,1,1,0,18,0.00018
Gustavo83294193,,,1,4,5,4,10,14,3,0.55,0.621212,0,18,0.00018
H0SSEIN__,,,0,1,1,0,1,1,1,1,1,0,18,0.00018
H0ZEIN,,,0,1,1,0,1,1,1,1,1,0,77,0.00018
H14917094,,,0,1,1,0,1,1,1,1,1,0,95,0.00018
H1rKdHtXQ0fYeuA,,,0,1,1,0,1,1,1,1,1,0,95,0.00018
H21Ammar,,,1,60,61,4,95,99,3,0.721311,0.829545,82.666667,95,0.000181
M77Zeinab,,,2,0,2,2,0,2,0,0,0,0,95,0.000184
abdasii,,,1,0,1,1,0,1,0,0,0,0,95,0.000183
armangarayi,,,2,0,2,2,0,2,0,0,0,0,95,0.000184
jhn313,,,2,0,2,2,0,2,0,0,0,0,95,0.000184
mehrdad_rabani,,,2,0,2,2,0,2,0,0,0,0,95,0.000184
tahere7075,,,2,0,2,8,0,8,0,0,0,0,95,0.000184
H67929901,,,0,1,1,0,1,1,1,1,1,0,179,0.00018
mahmoud18631,,,1,0,1,1,0,1,0,0,0,0,179,0.000334
H69jPDeLygttZOP,,,0,2,2,0,3,3,2,0.75,0.833333,0,18,0.00018
H6_Sh6,,,0,1,1,0,2,2,1,1,1,0,180,0.00018
RoHeidari,,,1,0,1,2,0,2,0,0,0,0,180,0.000334
HAL9088,,,0,1,1,0,1,1,1,1,1,0,18,0.00018
HAMED51850873,,,0,1,1,0,3,3,1,1,1,0,18,0.00018
MINAJAVADI2,,,1,0,1,1,0,1,0,0,0,0,18,0.000739
HARD_REVENGE38,,,0,1,1,0,3,3,1,1,1,0,18,0.00018
HApOKumaR,,,0,1,1,0,1,1,1,1,1,0,18,0.00018
HArbabb,,,1,3,4,1,3,4,1,1,1,0,12,0.00018
HBabavand,,,0,1,1,0,2,2,1,1,1,0,181,0.00018
MahdiSoli,,,1,0,1,2,0,2,0,0,0,0,181,0.000334
HBagherifard,,,0,1,1,0,2,2,1,1,1,0,182,0.00018
r_falahati,,,1,0,1,2,0,2,0,0,0,0,182,0.000334
HBahramikhah,,,0,2,2,0,2,2,1,1,1,0,77,0.00018
HBehnood,,,0,1,1,0,2,2,2,0.666667,0.75,0,77,0.00018
HD_dehnamaki,,,0,1,1,0,1,1,1,1,1,0,183,0.00018
khajeheydari,,,1,0,1,1,0,1,0,0,0,0,183,0.000334
HDjazeb,,,0,2,2,0,3,3,1,1,1,0,18,0.00018
HElaHi70,,,0,2,2,0,4,4,1,1,1,0,77,0.00018
HGhaaf,,,0,5,5,0,9,9,1,1,1,0,95,0.00018
Sarbaze312,,,1,0,1,2,0,2,0,0,0,0,95,0.000211
HHaiderGujjar,,,0,1,1,0,1,1,1,1,1,0,158,0.00018
HIZ1988,,,0,1,1,0,1,1,1,1,1,0,18,0.00018
HMilanloo,,,0,1,1,0,1,1,1,1,1,0,77,0.00018
HMtw63,,,0,1,1,0,2,2,1,1,1,0,87,0.00018
HNazeri2,,,0,2,2,0,4,4,1,1,1,0,95,0.00018
nina_h6055,,,1,0,1,2,0,2,0,0,0,0,95,0.000257
Asi69322981,,,1,0,1,1,0,1,0,0,0,0,95,0.000185
E_sml382,,,1,0,1,1,0,1,0,0,0,0,95,0.000185
ElhamAmiri17,,,1,0,1,3,0,3,0,0,0,0,95,0.000185
Hamed_B_Rad,,,1,1,2,1,5,6,1,1,1,0.5,95,0.000185
abolfazl987,,,1,0,1,1,0,1,0,0,0,0,95,0.000185
amir_khabjooni,,,1,0,1,1,0,1,0,0,0,0,95,0.000185
ehsanomidvar190,,,2,0,2,2,0,2,0,0,0,0,95,0.000192
hito_hachii,,,1,0,1,3,0,3,0,0,0,0,95,0.000185
kian_irani68,,,1,0,1,2,0,2,0,0,0,0,95,0.000185
m_ramezani313,,,1,0,1,1,0,1,0,0,0,0,95,0.000185
mbasamtabar,,,2,0,2,2,0,2,0,0,0,0,95,0.000339
realmimpanahi,,,1,0,1,1,0,1,0,0,0,0,95,0.000185
sajjaddehghan74,,,2,0,2,2,0,2,0,0,0,0,95,0.000339
shafiee__m,,,1,0,1,1,0,1,0,0,0,0,95,0.000185
sucexp,,,1,0,1,1,0,1,0,0,0,0,95,0.000185
zyb_mohammady,,,1,0,1,1,0,1,0,0,0,0,95,0.000185
HOSSEIN97361,,,0,14,14,0,25,25,2,0.818182,0.888889,0,18,0.00018
HP2J6pyAbeOvFCO,,,0,1,1,0,1,1,1,1,1,0,95,0.00018
HRHCoyToad,,,0,1,1,0,2,2,1,1,1,0,18,0.00018
HRMadihi,,,0,1,1,0,1,1,1,1,1,0,18,0.00018
HRouzitalab,,,0,1,1,0,2,2,1,1,1,0,184,0.00018
hani_hashami,,,1,0,1,2,0,2,0,0,0,0,184,0.000334
HSgord,,,0,3,3,0,5,5,1,1,1,0,12,0.00018
HYousefabadi,,,0,1,1,0,1,1,1,1,1,0,77,0.00018
ZZavvari,,,2,0,2,6,0,6,0,0,0,0,95,0.000528
H_Aghamohamadi,,,0,3,3,0,5,5,1,1,1,0,77,0.00018
samiraalampanah,,,1,0,1,2,0,2,0,0,0,0,77,0.000232
H_Esmaelpour,,,0,1,1,0,1,1,1,1,1,0,95,0.00018
H_akhavan222,,,0,1,1,0,1,1,1,1,1,0,95,0.00018
H_iran7K,,,0,1,1,0,1,1,1,1,1,0,77,0.00018
H_ramazanii1368,,,0,1,1,0,4,4,1,1,1,0,95,0.00018
HaMiD6138,,,0,1,1,0,2,2,1,1,1,0,95,0.00018
HaSaeideh,,,0,1,1,0,3,3,2,0.666667,0.75,0,95,0.00018
HabeJim,,,0,1,1,0,4,4,1,1,1,0,18,0.00018
HabibEskandari,,,0,1,1,0,2,2,1,1,1,0,77,0.00018
Hadi37667215,,,0,1,1,0,1,1,1,1,1,0,95,0.00018
HadiAhm71168473,,,0,1,1,0,1,1,2,0.666667,0.75,0,77,0.00018
HadiNezami,,,0,1,1,0,1,1,1,1,1,0,18,0.00018
HadiNili,,,0,2,2,0,3,3,1,1,1,0,18,0.00018
milaniabbas,,,2,0,2,2,0,2,0,0,0,0,18,0.000334
Hadi_Gomnam,,,0,6,6,0,11,11,2,0.75,0.833333,0,95,0.00018
Hadi_Jamali1991,,,0,1,1,0,2,2,1,1,1,0,77,0.00018
Hadiiss_,,,0,1,1,0,1,1,1,1,1,0,18,0.00018
Hadikarimian67,,,0,1,1,0,4,4,1,1,1,0,77,0.00018
HadisBahrami1,,,0,1,1,0,1,1,1,1,1,0,77,0.00018
Hadiseh1997,,,0,4,4,0,8,8,1,1,1,0,95,0.00018
HadyFallah,,,1,4,5,4,8,12,1,1,1,4,95,0.000183
mahrdad_fa13,,,1,0,1,2,0,2,0,0,0,0,95,0.00022
HaghiEsmaeil,,,0,1,1,0,2,2,1,1,1,0,95,0.00018
Haghighat_2,,,0,1,1,0,1,1,1,1,1,0,28,0.00018
HaghirSansorchi,,,0,5,5,0,9,9,1,1,1,0,18,0.00018
SHABNEVIS,,,2,0,2,3,0,3,0,0,0,0,18,0.000233
HajBehnam1,,,0,1,1,0,1,1,1,1,1,0,77,0.00018
HajMamad_,,,0,1,1,0,2,2,1,1,1,0,110,0.00018
HajObamaa,,,0,1,1,0,3,3,2,0.555556,0.6,0,95,0.00018
HajQasem4,,,0,1,1,0,2,2,1,1,1,0,18,0.00018
HajZanbour,,,0,4,4,0,5,5,2,0.7,0.785714,0,18,0.00018
h_rabeiy,,,1,0,1,1,0,1,0,0,0,0,18,0.000219
Haj_mirza,,,0,1,1,0,2,2,1,1,1,0,18,0.00018
Haji_Moalem,,,0,4,4,0,11,11,2,0.833333,0.9,0,95,0.00018
Hajibadoom,,,0,1,1,0,1,1,1,1,1,0,77,0.00018
HakimiAmiraslan,,,0,1,1,0,1,1,1,1,1,0,18,0.00018
HamPiyale,,,0,3,3,0,3,3,1,1,1,0,95,0.00018
HamaaseDovvom,,,0,1,1,0,2,2,1,1,1,0,95,0.00018
drmkhazali,,,2,0,2,5,0,5,0,0,0,0,95,0.000335
Haman_3r,,,0,1,1,0,1,1,2,0.538462,0.571429,0,18,0.00018
Hamchnanalireza,,,0,1,1,0,2,2,1,1,1,0,185,0.00018
mikel_anzh,,,1,0,1,2,0,2,0,0,0,0,185,0.000334
Hamcker,,,0,3,3,0,5,5,1,1,1,0,95,0.00018
Qadiram110,,,1,0,1,1,0,1,0,0,0,0,95,0.000232
HamdiiElahe,,,0,1,1,0,2,2,2,0.666667,0.75,0,95,0.00018
Hamed45052454,,,0,1,1,0,2,2,1,1,1,0,95,0.00018
Hamed65820772,,,0,7,7,0,13,13,1,1,1,0,18,0.00018
JalaliAmirReza,,,1,0,1,2,0,2,0,0,0,0,18,0.000202
Liberalist_30,,,2,0,2,4,0,4,0,0,0,0,18,0.000229
bimaghz_,,,1,0,1,2,0,2,0,0,0,0,18,0.000202
Hamed97587320,,,0,1,1,0,1,1,1,1,1,0,95,0.00018
HamedAsadi19,,,0,1,1,0,1,1,1,1,1,0,12,0.00018
Mehrdad_950,,,2,0,2,2,0,2,0,0,0,0,12,0.000411
HamedGanji,,,0,2,2,0,2,2,1,1,1,0,18,0.00018
HamedKaboudvand,,,0,4,4,0,7,7,1,1,1,0,95,0.00018
HamedMM14,,,0,1,1,0,2,2,1,1,1,0,154,0.00018
HamedMoadel,,,0,1,1,0,2,2,1,1,1,0,77,0.00018
HamedNajarzadeh,,,0,1,1,0,2,2,1,1,1,0,95,0.00018
HamedSoulati,,,0,1,1,0,1,1,1,1,1,0,186,0.00018
anti_leftist,,,1,0,1,1,0,1,0,0,0,0,186,0.000334
Hamedkamaa,,,0,1,1,0,2,2,1,1,1,0,95,0.00018
Hamedmoeini_,,,0,1,1,0,2,2,1,1,1,0,95,0.00018
Hamiazad1,,,0,1,1,0,1,1,1,1,1,0,77,0.00018
Hamid53373365,,,0,1,1,0,1,1,1,1,1,0,12,0.00018
Hamid75114890,,,0,1,1,0,1,1,1,1,1,0,77,0.00018
HamidCnc4,,,0,1,1,0,1,1,2,0.52381,0.545455,0,18,0.00018
HamidFarid1357,,,0,1,1,0,2,2,1,1,1,0,77,0.00018
HamidGoodarzi15,,,0,2,2,0,2,2,1,1,1,0,12,0.00018
HamidRe23478450,,,0,1,1,0,1,1,1,1,1,0,187,0.00018
mahdih22,,,1,0,1,1,0,1,0,0,0,0,187,0.000334
HamidRezaFara12,,,0,1,1,0,2,2,1,1,1,0,188,0.00018
h_kiaaa,,,1,0,1,2,0,2,0,0,0,0,188,0.000334
HamidShahpoory,,,0,1,1,0,2,2,1,1,1,0,18,0.00018
Hamid_Be44,,,0,1,1,0,1,1,1,1,1,0,77,0.00018
Hamid_Reza_MS,,,0,1,1,0,2,2,1,1,1,0,95,0.00018
Hamid_micro,,,0,4,4,0,6,6,1,1,1,0,18,0.00018
BENJAMINBATTONN,,,1,0,1,1,0,1,0,0,0,0,18,0.000219
HassanTavakol10,,,1,0,1,1,0,1,0,0,0,0,18,0.000219
mehr_dreamer,,,1,0,1,1,0,1,0,0,0,0,18,0.000219
Hamidch9170,,,0,2,2,0,3,3,2,0.75,0.833333,0,77,0.00018
Hamide_Sadat,,,0,2,2,0,3,3,2,0.75,0.833333,0,95,0.00018
vahid_taghavii,,,1,0,1,2,0,2,0,0,0,0,95,0.000257
Hamideh_eng,,,0,7,7,0,8,8,2,0.818182,0.888889,0,18,0.00018
Hamidk80508512,,,0,1,1,0,1,1,1,1,1,0,12,0.00018
Hamidra83334456,,,0,1,1,0,3,3,1,1,1,0,95,0.00018
Hamidrezaalimi8,,,0,2,2,0,3,3,1,1,1,0,77,0.00018
nemat_hafezi,,,2,0,2,4,0,4,0,0,0,0,77,0.000411
Hamidrz41,,,0,1,1,0,2,2,1,1,1,0,95,0.00018
Hamine_ke_has,,,0,5,5,0,7,7,2,0.666667,0.75,0,18,0.00018
HammerSima,,,0,1,1,0,1,1,1,1,1,0,18,0.00018
HamsareA,,,0,1,1,0,1,1,1,1,1,0,18,0.00018
HamsedaCA,,,1,1,2,1,1,2,0,0,0,0,189,0.00018
HamzeGhalebi,,,0,4,4,0,10,10,1,1,1,0,95,0.00018
HanSeoInam,,,0,2,2,0,2,2,2,0.6,0.666667,0,18,0.00018
nish_khatt,,,2,0,2,2,0,2,0,0,0,0,18,0.000334
Hanan_nezafat,,,0,8,8,0,11,11,1,1,1,0,95,0.00018
Hananeh_shb,,,0,1,1,0,2,2,1,1,1,0,190,0.00018
MIstaism67,,,1,0,1,2,0,2,0,0,0,0,190,0.000334
Hanea33754780,,,0,1,1,0,4,4,1,1,1,0,95,0.00018
HaniBird1,,,0,3,3,0,61,61,1,1,1,0,95,0.00018
m_KRadpoor,,,2,0,2,10,0,10,0,0,0,0,95,0.000242
nushabadi,,,1,0,1,55,0,55,0,0,0,0,95,0.000232
Hani_R_,,,0,1,1,0,2,2,1,1,1,0,95,0.00018
HanieYektaa,,,0,6,6,0,13,13,1,1,1,0,95,0.00018
Haniemasjudi,,,0,1,1,0,2,2,1,1,1,0,95,0.00018
Haniesoltanpour,,,0,1,1,0,2,2,1,1,1,0,191,0.00018
ehsan_soltani,,,1,0,1,2,0,2,0,0,0,0,191,0.000334
Hannah70397715,,,0,1,1,0,2,2,1,1,1,0,18,0.00018
HannahRzv,,,0,1,1,0,1,1,1,1,1,0,18,0.00018
Happymappy88,,,0,1,1,0,2,2,1,1,1,0,192,0.00018
shahidamkon,,,2,0,2,4,0,4,0,0,0,0,192,0.000488
HarchiHarki,,,0,4,4,0,5,5,1,1,1,0,18,0.00018
HardRock131313,,,0,3,3,0,4,4,2,0.714286,0.8,0,18,0.00018
sadaf_ef,,,1,0,1,1,0,1,0,0,0,0,18,0.000232
HariMahdiyar,,,0,1,1,0,1,1,1,1,1,0,193,0.00018
fakhrian_m,,,1,0,1,1,0,1,0,0,0,0,193,0.000334
Harvveyspecter,,,0,1,1,0,2,2,1,1,1,0,87,0.00018
Hasanagha,,,0,1,1,0,1,1,1,1,1,0,18,0.00018
Hasanali_shaker,,,0,4,4,0,6,6,1,1,1,0,95,0.00018
Helma_2210,,,1,0,1,2,0,2,0,0,0,0,95,0.000219
Siavoshi3,,,1,0,1,1,0,1,0,0,0,0,95,0.000219
HasanpourAhsan,,,0,2,2,0,2,2,3,0.470588,0.5625,0,18,0.00018
daryoush_twt,,,1,0,1,1,0,1,0,0,0,0,18,0.000257
Hasanreza_bk,,,0,7,7,0,11,11,3,0.460177,0.516026,0,95,0.00018
Mirjvd1,,,1,0,1,1,0,1,0,0,0,0,95,0.000202
Hassan136628778,,,0,1,1,0,1,1,1,1,1,0,95,0.00018
HassanH71708783,,,0,1,1,0,1,1,1,1,1,0,95,0.00018
HassanZD1991,,,0,1,1,0,1,1,1,1,1,0,194,0.00018
MohajerMr,,,1,0,1,1,0,1,0,0,0,0,194,0.000334
Hassan__Hadi,,,0,1,1,0,1,1,1,1,1,0,12,0.00018
Hassan_t_e,,,1,7,8,2,12,14,2,0.8,0.875,0,95,0.00018
Hassani13486336,,,0,1,1,0,1,1,1,1,1,0,18,0.00018
Hassann50,,,0,1,1,0,1,1,1,1,1,0,12,0.00018
HassannezhadMr,,,0,1,1,0,1,1,1,1,1,0,18,0.00018
Hasti1400,,,0,8,8,0,11,11,2,0.7,0.785714,0,95,0.00018
ali_mohamad68,,,1,0,1,1,0,1,0,0,0,0,95,0.0002
ghalbmseyedAli,,,1,0,1,2,0,2,0,0,0,0,95,0.0002
pesarkordmlan,,,1,0,1,1,0,1,0,0,0,0,95,0.0002
sarbazesa,,,1,0,1,1,0,1,0,0,0,0,95,0.0002
Hasti22889220,,,0,1,1,0,1,1,1,1,1,0,95,0.00018
HastiGh4,,,0,18,18,0,31,31,3,0.702703,0.826923,0,18,0.00018
bi_orzeghan,,,1,0,1,1,0,1,0,0,0,0,18,0.000189
bidarbashid,,,1,0,1,2,0,2,0,0,0,0,18,0.000189
Hastiii3535,,,0,1,1,0,2,2,1,1,1,0,195,0.00018
M_A_saleh72,,,1,0,1,2,0,2,0,0,0,0,195,0.000334
Hasty89274739,,,0,62,62,0,119,119,3,0.688889,0.81362,0,95,0.00018
Iman_hero1,,,1,0,1,3,0,3,0,0,0,0,95,0.000183
LPdAy9j2T6ZLCc1,,,1,0,1,2,0,2,0,0,0,0,95,0.000183
MLotfi_98,,,1,0,1,1,0,1,0,0,0,0,95,0.000183
davoodabadi313,,,1,0,1,3,0,3,0,0,0,0,95,0.000183
yosofefateme,,,1,0,1,1,0,1,0,0,0,0,95,0.000183
Hastyarrr_,,,0,2,2,0,3,3,2,0.6,0.666667,0,18,0.00018
EliosaT,,,1,0,1,1,0,1,0,0,0,0,18,0.000257
HatefiOmid,,,0,1,1,0,1,1,1,1,1,0,77,0.00018
Hatrikain,,,0,1,1,0,1,1,1,1,1,0,18,0.00018
Hdmnac,,,0,1,1,0,1,1,1,1,1,0,18,0.00018
He3um,,,0,1,1,0,1,1,1,1,1,0,196,0.00018
mam__mad,,,1,0,1,1,0,1,0,0,0,0,196,0.000334
He_Will_Come135,,,0,9,9,0,20,20,3,0.466019,0.538194,0,95,0.00018
Heath4joker,,,0,2,2,0,4,4,1,1,1,0,18,0.00018
Hedayat24015106,,,0,1,1,0,1,1,1,1,1,0,197,0.00018
mansoorehtaher1,,,2,0,2,2,0,2,0,0,0,0,197,0.000488
Hedella_,,,0,1,1,0,1,1,2,0.666667,0.75,0,95,0.00018
Hein_himler,,,0,2,2,0,2,2,1,1,1,0,18,0.00018
Heizenburger,,,0,1,1,0,1,1,1,1,1,0,18,0.00018
HejaziSeyed,,,0,2,2,0,2,2,1,1,1,0,77,0.00018
HekmatMahrokh,,,0,1,1,0,2,2,2,0.6,0.666667,0,95,0.00018
Hekmatesayyal,,,0,2,2,0,4,4,1,1,1,0,95,0.00018
mehdi_izanlo,,,2,0,2,3,0,3,0,0,0,0,95,0.000258
HelmaSadeghi,,,0,1,1,0,1,1,2,0.666667,0.75,0,95,0.00018
HemenoMurry,,,0,1,1,0,1,1,1,1,1,0,77,0.00018
Heraaa26,,,0,1,1,0,1,1,2,0.666667,0.75,0,18,0.00018
Hero4Iran,,,0,2,2,0,4,4,1,1,1,0,95,0.00018
HerrMDL,,,0,1,1,0,1,1,1,1,1,0,18,0.00018
HerrSTGM,,,0,1,1,0,1,1,1,1,1,0,18,0.00018
Herrlouwe,,,0,1,1,0,1,1,1,1,1,0,18,0.00018
HerrrtCity,,,0,1,1,0,1,1,1,1,1,0,18,0.00018
Hesam_msvi,,,0,1,1,0,1,1,1,1,1,0,18,0.00018
Hesamsalehi8089,,,0,1,1,0,3,3,1,1,1,0,198,0.00018
mra_313,,,1,0,1,3,0,3,0,0,0,0,198,0.000334
Heydar8700,,,0,1,1,0,1,1,1,1,1,0,50,0.00018
Heydari_arak,,,0,1,1,0,1,1,1,1,1,0,142,0.00018
HiDDeN_elite,,,0,1,1,0,1,1,1,1,1,0,85,0.00018
Hich76374686,,,0,2,2,0,2,2,1,1,1,0,18,0.00018
AzadoRahha,,,1,0,1,1,0,1,0,0,0,0,18,0.000257
HiddenW50739069,,,0,9,9,0,13,13,2,0.736842,0.821429,0,18,0.00018
nikan1360,,,1,0,1,1,0,1,0,0,0,0,18,0.000198
Hisoka1000,,,0,2,2,0,4,4,1,1,1,0,95,0.00018
Hitman392687461,,,0,2,2,0,2,2,1,1,1,0,18,0.00018
Hkb8410,,,0,1,1,0,1,1,1,1,1,0,18,0.00018
Hkhwizard,,,0,2,2,0,2,2,1,1,1,0,4,0.00018
NaHann_13,,,2,0,2,2,0,2,0,0,0,0,4,0.000411
Hm82872736,,,0,2,2,0,2,2,1,1,1,0,18,0.00018
Hmed_Mjd,,,0,1,1,0,2,2,1,1,1,0,18,0.00018
HoSeN_RmR,,,0,2,2,0,5,5,3,0.529412,0.592593,0,77,0.00018
f_h_h_f,,,1,0,1,1,0,1,0,0,0,0,95,0.000328
Hojatchs,,,0,1,1,0,2,2,1,1,1,0,95,0.00018
Holy720,,,0,27,27,0,52,52,3,0.563636,0.682796,0,95,0.00018
Homayonamm,,,0,1,1,0,1,1,1,1,1,0,18,0.00018
Homayou15572496,,,0,1,1,0,2,2,1,1,1,0,95,0.00018
Homosap20759198,,,0,7,7,0,9,9,6,0.263473,0.368182,0,18,0.00018
HondoriMostafa,,,0,1,1,0,2,2,1,1,1,0,76,0.00018
Honey_gol,,,0,1,1,0,1,1,1,1,1,0,199,0.00018
Amirgol_ir,,,1,0,1,1,0,1,0,0,0,0,199,0.000334
Honey_mnik,,,0,1,1,0,1,1,3,0.5,0.527778,0,18,0.00018
Hoodathastam,,,0,1,1,0,1,1,1,1,1,0,77,0.00018
Hoomanism1,,,0,2,2,0,2,2,1,1,1,0,18,0.00018
Hoomet3,,,0,1,1,0,1,1,1,1,1,0,18,0.00018
Hoora70,,,0,1,1,0,1,1,1,1,1,0,77,0.00018
Hooshan79089946,,,0,1,1,0,1,1,1,1,1,0,12,0.00018
HooshangRoozba5,,,0,2,2,0,2,2,1,1,1,0,12,0.00018
1356hasanp,,,1,0,1,1,0,1,0,0,0,0,95,0.000181
Ahoora9117,,,1,0,1,2,0,2,0,0,0,0,95,0.000181
Ali20063766,,,2,0,2,6,0,6,0,0,0,0,95,0.000258
Amir75494390,,,1,0,1,1,0,1,0,0,0,0,95,0.000181
Amoo_Ali_Aslani,,,1,0,1,1,0,1,0,0,0,0,95,0.000181
Aram_bano313,,,1,0,1,3,0,3,0,0,0,0,95,0.000181
Asadat25438993,,,1,0,1,3,0,3,0,0,0,0,95,0.000181
Enemy_Black_Cat,,,1,0,1,1,0,1,0,0,0,0,95,0.000181
Good2020m,,,1,0,1,1,0,1,0,0,0,0,95,0.000181
Jalali1325,,,1,0,1,1,0,1,0,0,0,0,95,0.000181
Koruji97,,,1,0,1,3,0,3,0,0,0,0,95,0.000181
MH_Benvidi,,,1,0,1,1,0,1,0,0,0,0,95,0.000181
MKheyri937,,,1,0,1,3,0,3,0,0,0,0,95,0.000181
Mehdi29367197,,,1,0,1,1,0,1,0,0,0,0,95,0.000181
Mohamad99049131,,,1,0,1,1,0,1,0,0,0,0,95,0.000181
MrEli17,,,1,0,1,1,0,1,0,0,0,0,95,0.000181
MrTaqian,,,1,0,1,1,0,1,0,0,0,0,95,0.000181
NHSEM72313,,,1,0,1,1,0,1,0,0,0,0,95,0.000181
Negaar4,,,1,0,1,1,0,1,0,0,0,0,95,0.000181
O4TN6qbWtCTZzG5,,,1,0,1,2,0,2,0,0,0,0,95,0.000181
Patriot_170985,,,1,0,1,1,0,1,0,0,0,0,95,0.000181
Rghahremaniiiii,,,1,0,1,3,0,3,0,0,0,0,95,0.000181
Ritjavan,,,1,0,1,1,0,1,0,0,0,0,95,0.000181
SDQOvqBxXwVAB2a,,,1,0,1,1,0,1,0,0,0,0,95,0.000181
SHR44203836,,,1,0,1,1,0,1,0,0,0,0,95,0.000181
SZAbdollahi2,,,1,0,1,3,0,3,0,0,0,0,95,0.000181
Sanaziii1990,,,1,0,1,3,0,3,0,0,0,0,95,0.000181
Shaghayegh_ab1,,,1,0,1,1,0,1,0,0,0,0,95,0.000181
Smmemadi1,,,1,0,1,1,0,1,0,0,0,0,95,0.000181
V_Heidarzadeh,,,1,0,1,1,0,1,0,0,0,0,95,0.000181
YOg5Sed8Ggh8DCY,,,1,0,1,1,0,1,0,0,0,0,95,0.000181
Yarmohamadi313,,,1,0,1,1,0,1,0,0,0,0,95,0.000181
a0UHdTWhHnMQnmI,,,1,0,1,1,0,1,0,0,0,0,95,0.000181
aliakbarvh,,,1,0,1,2,0,2,0,0,0,0,95,0.000181
aliifatemy,,,1,0,1,2,0,2,0,0,0,0,95,0.000181
amin_ghafarii,,,1,0,1,1,0,1,0,0,0,0,95,0.000181
amir_mn76,,,1,0,1,3,0,3,0,0,0,0,95,0.000181
antienemy313,,,1,0,1,1,0,1,0,0,0,0,95,0.000181
aramhosein,,,1,0,1,1,0,1,0,0,0,0,95,0.000181
axneveshtesiyas,,,1,0,1,2,0,2,0,0,0,0,95,0.000181
bitaahmadi6388,,,1,0,1,1,0,1,0,0,0,0,95,0.000181
dadashkayko1369,,,1,0,1,1,0,1,0,0,0,0,95,0.000181
ehsan_tayyar,,,1,0,1,1,0,1,0,0,0,0,95,0.000181
enghelabiam6969,,,1,0,1,1,0,1,0,0,0,0,95,0.000181
f_rira_a,,,1,0,1,3,0,3,0,0,0,0,95,0.000181
farzinnaderian,,,1,0,1,1,0,1,0,0,0,0,95,0.000181
fatmehgafari,,,1,0,1,1,0,1,0,0,0,0,95,0.000181
ghadam98,,,1,0,1,1,0,1,0,0,0,0,95,0.000181
ghaem61,,,1,0,1,1,0,1,0,0,0,0,95,0.000181
hamid99366830,,,1,0,1,1,0,1,0,0,0,0,95,0.000181
hamid_or,,,1,0,1,1,0,1,0,0,0,0,95,0.000181
hassanak1369,,,1,0,1,1,0,1,0,0,0,0,95,0.000181
hastipaeez1,,,1,0,1,1,0,1,0,0,0,0,95,0.000181
irancybergroup,,,1,0,1,1,0,1,0,0,0,0,95,0.000181
k_mahdipour,,,1,0,1,1,0,1,0,0,0,0,95,0.000181
khademi1989,,,1,0,1,1,0,1,0,0,0,0,95,0.000181
khalil_jabaleh,,,1,0,1,1,0,1,0,0,0,0,95,0.000181
kod_sm,,,1,0,1,3,0,3,0,0,0,0,95,0.000181
m_reza_hoveyzeh,,,1,0,1,1,0,1,0,0,0,0,95,0.000181
marjan_rad_,,,1,0,1,2,0,2,0,0,0,0,95,0.000181
mir_1992m,,,1,0,1,1,0,1,0,0,0,0,95,0.000181
mmoparizad,,,1,0,1,3,0,3,0,0,0,0,95,0.000181
mohamadsalimi69,,,2,0,2,2,0,2,0,0,0,0,95,0.000188
mohammad3524854,,,1,0,1,1,0,1,0,0,0,0,95,0.000181
mohammad_zirak,,,1,0,1,3,0,3,0,0,0,0,95,0.000181
mrratki,,,1,0,1,1,0,1,0,0,0,0,95,0.000181
nabjahadi_twitt,,,1,0,1,1,0,1,0,0,0,0,95,0.000181
nahidvarzandeh9,,,1,0,1,1,0,1,0,0,0,0,95,0.000181
negar_sedaghati,,,1,0,1,3,0,3,0,0,0,0,95,0.000181
oxCAQG7hoJxKcfg,,,1,0,1,3,0,3,0,0,0,0,95,0.000181
parsazarafshan,,,1,0,1,1,0,1,0,0,0,0,95,0.000181
razavi1380,,,1,0,1,3,0,3,0,0,0,0,95,0.000181
reyhan_pay,,,1,0,1,1,0,1,0,0,0,0,95,0.000181
ruvy3wd,,,1,0,1,1,0,1,0,0,0,0,95,0.000181
saeed24401093,,,1,0,1,4,0,4,0,0,0,0,95,0.000181
sajjad50217731,,,1,0,1,3,0,3,0,0,0,0,95,0.000181
salam_33333,,,1,0,1,2,0,2,0,0,0,0,95,0.000181
sepehrkz110,,,1,0,1,1,0,1,0,0,0,0,95,0.000181
shab_gol65,,,1,0,1,3,0,3,0,0,0,0,95,0.000181
sharifionline,,,1,0,1,1,0,1,0,0,0,0,95,0.000181
syerf2,,,1,0,1,1,0,1,0,0,0,0,95,0.000181
taha_monavvari,,,1,0,1,1,0,1,0,0,0,0,95,0.000181
talangor_ism,,,1,0,1,1,0,1,0,0,0,0,95,0.000181
tired_73,,,1,0,1,1,0,1,0,0,0,0,95,0.000181
u16u4JSiATa9aCW,,,1,0,1,3,0,3,0,0,0,0,95,0.000181
valizadehmonir,,,1,0,1,1,0,1,0,0,0,0,95,0.000181
zlfirozjaei,,,1,0,1,2,0,2,0,0,0,0,95,0.000181
HormozdY,,,0,1,1,0,1,1,1,1,1,0,18,0.00018
HoseiinNm,,,0,5,5,0,6,6,1,1,1,0,95,0.00018
Hosein2400,,,0,1,1,0,1,1,1,1,1,0,77,0.00018
Hosein456,,,0,1,1,0,1,1,1,1,1,0,95,0.00018
HoseinBlaugrana,,,0,3,3,0,4,4,1,1,1,0,18,0.00018
HoseiniMohana,,,0,3,3,0,5,5,1,1,1,0,95,0.00018
Hosien74713309,,,0,9,9,0,29,29,1,1,1,0,95,0.00018
Hosna10043450,,,0,1,1,0,3,3,1,1,1,0,95,0.00018
Hosna__6677,,,0,1,1,0,2,2,1,1,1,0,95,0.00018
Hosnieh4,,,0,2,2,0,3,3,1,1,1,0,77,0.00018
HossK88,,,0,1,1,0,1,1,1,1,1,0,18,0.00018
Hossein16999987,,,0,1,1,0,2,2,1,1,1,0,95,0.00018
HosseinGharbavi,,,0,1,1,0,1,1,1,1,1,0,95,0.00018
Nosrati1404,,,2,0,2,2,0,2,0,0,0,0,95,0.000373
HosseinKhalaj4,,,0,1,1,0,2,2,1,1,1,0,95,0.00018
HosseinMahmoo14,,,0,1,1,0,2,2,1,1,1,0,95,0.00018
HosseinTebyan,,,0,2,2,0,2,2,1,1,1,0,18,0.00018
HosseinZamani72,,,0,5,5,0,6,6,3,0.666667,0.791667,0,95,0.00018
seastar_255,,,1,0,1,1,0,1,0,0,0,0,95,0.000211
Hossein_110_M,,,0,2,2,0,3,3,1,1,1,0,77,0.00018
Hossein_Eisvand,,,1,1,2,2,2,4,0,0,0,0,200,0.00018
Hossein__salehi,,,0,1,1,0,2,2,1,1,1,0,77,0.00018
Hossein_baygi,,,0,2,2,0,4,4,1,1,1,0,95,0.00018
Reza1998Rn,,,1,0,1,2,0,2,0,0,0,0,95,0.000257
Hossein_moaref,,,1,1,2,2,2,4,0,0,0,0,201,0.00018
Hosseinbakhti12,,,0,1,1,0,1,1,1,1,1,0,77,0.00018
HosseiniAyat,,,0,1,1,0,1,1,1,1,1,0,18,0.00018
HosseiniSeyede,,,0,1,1,0,2,2,1,1,1,0,162,0.00018
HosseiniWTC,,,0,2,2,0,3,3,1,1,1,0,95,0.00018
Hosseinpiuos,,,0,1,1,0,3,3,1,1,1,0,95,0.00018
Hosseinsepahi,,,0,1,1,0,1,1,1,1,1,0,18,0.00018
Hossien37497659,,,0,2,2,0,2,2,1,1,1,0,95,0.00018
Lions35919564,,,1,0,1,1,0,1,0,0,0,0,95,0.000257
HouramShalom,,,0,1,1,0,6,6,1,1,1,0,18,0.00018
Howliliy,,,0,1,1,0,1,1,1,1,1,0,202,0.00018
MohFiruzeh,,,1,0,1,1,0,1,0,0,0,0,202,0.000334
Htaheri17,,,0,3,3,0,6,6,1,1,1,0,95,0.00018
ParagraphMedia,,,1,0,1,2,0,2,0,0,0,0,95,0.000232
Huckleberyazad,,,0,1,1,0,1,1,1,1,1,0,18,0.00018
Hug27243688,,,0,3,3,0,3,3,1,1,1,0,18,0.00018
Human_Loves,,,1,4,5,2,9,11,1,1,1,0,18,0.00018
Humanit_arian,,,0,6,6,0,7,7,2,0.625,0.7,0,18,0.00018
HusainJJ,,,0,1,1,0,2,2,1,1,1,0,95,0.00018
HusseinPashaei,,,0,1,1,0,2,2,1,1,1,0,77,0.00018
Hussein_ETEco,,,0,1,1,0,2,2,1,1,1,0,203,0.00018
Aghel_ir,,,1,0,1,2,0,2,0,0,0,0,203,0.000334
Hussein_Mahdy22,,,0,1,1,0,1,1,1,1,1,0,95,0.00018
Hv_Jamasp,,,0,2,2,0,3,3,1,1,1,0,77,0.00018
bereshte_worker,,,1,0,1,1,0,1,0,0,0,0,77,0.000257
Hvn14nfs,,,0,7,7,0,14,14,1,1,1,0,77,0.00018
Mhk76136,,,1,0,1,1,0,1,0,0,0,0,77,0.000202
TAJEAM1324,,,1,0,1,2,0,2,0,0,0,0,77,0.000202
ahorashahi1366,,,1,0,1,2,0,2,0,0,0,0,77,0.000202
sedagha0,,,1,0,1,2,0,2,0,0,0,0,77,0.000202
HzrTVaLA7,,,0,1,1,0,1,1,1,1,1,0,95,0.00018
I1HPhofNGqFMVbl,,,0,5,5,0,8,8,1,1,1,0,18,0.00018
I85b71pmRLgTEnt,,,0,2,2,0,4,4,1,1,1,0,18,0.00018
IDOKIRKHAR,,,0,1,1,0,1,1,1,1,1,0,77,0.00018
ILIYA210,,,0,1,1,0,1,1,1,1,1,0,28,0.00018
ILIYA88874590,,,0,1,1,0,1,1,1,1,1,0,4,0.00018
IMikaili,,,0,1,1,0,1,1,1,1,1,0,197,0.00018
IRANIANguardian,,,0,3,3,0,4,4,1,1,1,0,18,0.00018
tsiolkovsky_Ir,,,1,0,1,1,0,1,0,0,0,0,18,0.000232
IRRefugeesInTR,,,0,1,1,0,2,2,1,1,1,0,18,0.00018
ITMAN1111,,,0,1,1,0,2,2,1,1,1,0,18,0.00018
IWithNoDot,,,0,4,4,0,5,5,1,1,1,0,18,0.00018
bozmajjje,,,1,0,1,1,0,1,0,0,0,0,18,0.000219
I_IastI,,,0,1,1,0,1,1,1,1,1,0,77,0.00018
I_R_A_N_I_A,,,0,1,1,0,5,5,1,1,1,0,18,0.00018
I_am_A_mammad,,,0,1,1,0,1,1,1,1,1,0,77,0.00018
IamAyeBikolah,,,0,1,1,0,1,1,1,1,1,0,204,0.00018
nazari2566,,,1,0,1,1,0,1,0,0,0,0,204,0.000334
IamMehrad,,,0,1,1,0,1,1,1,1,1,0,205,0.00018
davamolmolk,,,1,0,1,1,0,1,0,0,0,0,205,0.000334
IamRadvin1,,,0,2,2,0,3,3,1,1,1,0,18,0.00018
Ibiomedic,,,0,2,2,0,2,2,1,1,1,0,77,0.00018
Id_Strong,,,0,1,1,0,1,1,1,1,1,0,206,0.00018
saeede_149t,,,1,0,1,1,0,1,0,0,0,0,206,0.000334
IlliterateTwitt,,,0,1,1,0,1,1,1,1,1,0,18,0.00018
Ilvbin,,,0,4,4,0,8,8,2,0.833333,0.9,0,18,0.00018
Im_nobody_who_U,,,1,2,3,1,2,3,1,1,1,0,18,0.00018
Iman64594417,,,0,1,1,0,1,1,1,1,1,0,18,0.00018
ImanYari,,,0,1,1,0,1,1,1,1,1,0,18,0.00018
Imanuell_CUNT,,,0,1,1,0,2,2,1,1,1,0,18,0.00018
Imiriya,,,1,1,2,1,1,2,0,0,0,0,207,0.00018
ImojiT,,,0,1,1,0,1,1,1,1,1,0,18,0.00018
ImperialPersian,,,0,2,2,0,2,2,1,1,1,0,18,0.00018
Inner_Prophet_,,,0,2,2,0,4,4,1,1,1,0,77,0.00018
InsideIran_24,,,0,1,1,0,1,1,1,1,1,0,18,0.00018
InsideOut_s,,,0,1,1,0,1,1,1,1,1,0,77,0.00018
IraanianPatriot,,,0,1,1,0,2,2,1,1,1,0,18,0.00018
Iran114114,,,0,2,2,0,17,17,1,1,1,0,95,0.00018
hawzahnews_fa,,,1,0,1,1,0,1,0,0,0,0,95,0.000257
Iran12345m,,,1,2,3,3,5,8,1,1,1,0,208,0.00018
Azadi99999,,,1,0,1,2,0,2,0,0,0,0,208,0.000257
Iran832Ch,,,0,1,1,0,2,2,2,0.666667,0.75,0,18,0.00018
IranAzadiNow,,,0,1,1,0,1,1,1,1,1,0,12,0.00018
IranConvention,,,0,1,1,0,1,1,1,1,1,0,12,0.00018
IranElection,,,0,1,1,0,1,1,1,1,1,0,209,0.00018
IranianProtest,,,2,1,3,2,1,3,0,0,0,0,209,0.000334
IranGeiv,,,0,2,2,0,4,4,1,1,1,0,18,0.00018
IranParty1,,,1,29,30,2,57,59,2,0.78,0.858974,0,18,0.00018
FarhadRahimpour,,,1,0,1,1,0,1,0,0,0,0,18,0.000186
KayanTabrizi,,,1,1,2,2,1,3,1,1,1,1,18,0.000186
MohamadPayambar,,,1,0,1,1,0,1,0,0,0,0,18,0.000186
PRINCE_PERSIA77,,,1,0,1,2,0,2,0,0,0,0,18,0.000186
Shirinto,,,1,0,1,4,0,4,0,0,0,0,18,0.000186
YekMosibat,,,1,0,1,2,0,2,0,0,0,0,18,0.000186
aradpm,,,1,0,1,1,0,1,0,0,0,0,18,0.000186
hanif_doust,,,1,0,1,2,0,2,0,0,0,0,18,0.000186
hose40,,,1,0,1,2,0,2,0,0,0,0,18,0.000186
lila74713315,,,1,0,1,1,0,1,0,0,0,0,18,0.000186
mehransmart,,,1,0,1,6,0,6,0,0,0,0,18,0.000186
paniiisha,,,1,0,1,2,0,2,0,0,0,0,18,0.000186
real_marxism,,,1,0,1,2,0,2,0,0,0,0,18,0.000186
seyeddarwin,,,1,0,1,2,0,2,0,0,0,0,18,0.000186
sharrdoooni,,,1,0,1,1,0,1,0,0,0,0,18,0.000186
us_arz7,,,1,0,1,2,0,2,0,0,0,0,18,0.000186
IranSadegh,,,0,2,2,0,4,4,1,1,1,0,77,0.00018
IranSpartacus,,,0,1,1,0,1,1,1,1,1,0,28,0.00018
ShahabVengador,,,2,0,2,2,0,2,0,0,0,0,28,0.000386
Iran_Farda1,,,0,1,1,0,1,1,1,1,1,0,18,0.00018
Iran_Mani1,,,0,1,1,0,6,6,1,1,1,0,210,0.00018
Iran_dokht1365,,,0,2,2,0,2,2,2,0.666667,0.75,0,18,0.00018
Rozitta_Rosett,,,1,0,1,1,0,1,0,0,0,0,18,0.000257
Iranaza13122969,,,0,2,2,0,2,2,1,1,1,0,18,0.00018
Iranban98,,,0,1,1,0,2,2,1,1,1,0,18,0.00018
Irandost18,,,0,1,1,0,1,1,1,1,1,0,18,0.00018
Irandoxt,,,0,1,1,0,1,1,1,1,1,0,211,0.00018
ghebleye_aalam,,,1,0,1,1,0,1,0,0,0,0,211,0.000334
IraneAzaad2018,,,0,1,1,0,2,2,1,1,1,0,212,0.00018
MoussaTaghi,,,1,0,1,2,0,2,0,0,0,0,212,0.000334
IraneAzadFree1,,,0,1,1,0,1,1,1,1,1,0,12,0.00018
Iranfozool,,,1,4,5,1,7,8,1,1,1,0,77,0.00018
Irani123451,,,1,1,2,2,2,4,0,0,0,0,213,0.00018
IraniSogand,,,0,1,1,0,2,2,1,1,1,0,95,0.00018
Iraniam13,,,0,52,52,0,119,119,2,0.893939,0.940678,0,95,0.00018
Hadi_delha,,,2,0,2,2,0,2,0,0,0,0,95,0.00026
Panah_8,,,1,0,1,1,0,1,0,0,0,0,95,0.000183
RezvanZs,,,1,0,1,4,0,4,0,0,0,0,95,0.000183
Sardar1450,,,1,0,1,4,0,4,0,0,0,0,95,0.000183
davandeh1396,,,1,0,1,1,0,1,0,0,0,0,95,0.000183
mersadnews_ir,,,1,0,1,1,0,1,0,0,0,0,95,0.000183
mhrezamd_k,,,1,0,1,3,0,3,0,0,0,0,95,0.000183
sogand_ki5,,,1,0,1,1,0,1,0,0,0,0,95,0.000183
yaamahdi12,,,1,0,1,2,0,2,0,0,0,0,95,0.000183
yafateemeh,,,1,0,1,3,0,3,0,0,0,0,95,0.000183
Turkmen_Erkek,,,1,0,1,1,0,1,0,0,0,0,18,0.000211
omid_del,,,1,0,1,1,0,1,0,0,0,0,18,0.000211
saman_saedii,,,1,0,1,1,0,1,0,0,0,0,18,0.000211
IranianPiruzz9,,,0,3,3,0,8,8,6,0.257353,0.314286,0,18,0.00018
kouroshbozorg24,,,1,0,1,1,0,1,0,0,0,0,18,0.000232
IranianRepubli1,,,0,1,1,0,1,1,1,1,1,0,18,0.00018
IranianUtopian,,,0,5,5,0,8,8,2,0.692308,0.777778,0,18,0.00018
IranianWarrior1,,,0,2,2,0,4,4,1,1,1,0,77,0.00018
Iranian_son,,,0,3,3,0,6,6,1,1,1,0,214,0.00018
BrKosar,,,1,0,1,2,0,2,0,0,0,0,214,0.000232
modafeghods313,,,1,0,1,2,0,2,0,0,0,0,214,0.000232
zahrahb,,,1,0,1,2,0,2,0,0,0,0,214,0.000232
Iraniangirl_97,,,0,2,2,0,3,3,1,1,1,0,95,0.00018
Ezio_king_ac,,,1,0,1,2,0,2,0,0,0,0,95,0.000257
Iraniparsa2577,,,1,1,2,1,1,2,0,0,0,0,215,0.00018
IraniumG,,,0,2,2,0,3,3,1,1,1,0,95,0.00018
Iranjoun,,,0,1,1,0,1,1,1,1,1,0,18,0.00018
Irankaraj,,,0,1,1,0,1,1,1,1,1,0,12,0.00018
IranmaneshNavid,,,0,1,1,0,1,1,1,1,1,0,12,0.00018
Iranoma,,,0,1,1,0,1,1,1,1,1,0,77,0.00018
Iranshomarr,,,0,24,24,0,53,53,1,1,1,0,95,0.00018
AntiJafang,,,1,0,1,3,0,3,0,0,0,0,95,0.000187
ArabanAmir,,,1,0,1,3,0,3,0,0,0,0,95,0.000187
HnO3_ZeD,,,1,0,1,2,0,2,0,0,0,0,95,0.000187
Hossein_G_T,,,1,0,1,3,0,3,0,0,0,0,95,0.000187
MDahooki,,,1,0,1,1,0,1,0,0,0,0,95,0.000187
Mohamma72509986,,,1,0,1,1,0,1,0,0,0,0,95,0.000187
Mojtabaa57,,,1,0,1,1,0,1,0,0,0,0,95,0.000187
Seyed130,,,1,0,1,1,0,1,0,0,0,0,95,0.000187
_SepahSalar,,,1,0,1,3,0,3,0,0,0,0,95,0.000187
alirstmi,,,1,0,1,1,0,1,0,0,0,0,95,0.000187
javadinasab_m,,,1,0,1,2,0,2,0,0,0,0,95,0.000187
m_bagheri_1996,,,1,0,1,1,0,1,0,0,0,0,95,0.000187
mahdi_es10,,,1,0,1,3,0,3,0,0,0,0,95,0.000187
mahdijesusZ,,,1,0,1,2,0,2,0,0,0,0,95,0.000187
palizban1990,,,1,0,1,3,0,3,0,0,0,0,95,0.000187
saeed_jaha,,,1,0,1,2,0,2,0,0,0,0,95,0.000187
sepid_yal,,,1,0,1,1,0,1,0,0,0,0,95,0.000187
seyed__ahmad,,,1,0,1,1,0,1,0,0,0,0,95,0.000187
IranzadMagazine,,,0,2,2,0,3,3,1,1,1,0,18,0.00018
Iranzainab,,,0,2,2,0,3,3,1,1,1,0,95,0.00018
Iranzorro,,,0,1,1,0,1,1,1,1,1,0,18,0.00018
IribZanjan,,,1,2,3,2,3,5,1,1,1,0,142,0.00018
Irrraaannn,,,0,1,1,0,2,2,1,1,1,0,216,0.00018
Dr__sociologist,,,1,0,1,2,0,2,0,0,0,0,216,0.000334
Isatis1988,,,0,1,1,0,2,2,1,1,1,0,192,0.00018
Itisway13,,,0,2,2,0,3,3,1,1,1,0,18,0.00018
Itry2Bpositive,,,0,2,2,0,4,4,1,1,1,0,95,0.00018
ItweetSoIExist,,,0,7,7,0,10,10,1,1,1,0,18,0.00018
amirpersia,,,1,0,1,1,0,1,0,0,0,0,18,0.000202
Ivans_makhof,,,0,1,1,0,1,1,1,1,1,0,18,0.00018
IyWlw0Nv1pP9L95,,,0,1,1,0,1,1,1,1,1,0,18,0.00018
Izadtus,,,0,1,1,0,2,2,2,0.666667,0.75,0,18,0.00018
JAMILHAMIDI1,,,0,1,1,0,1,1,1,1,1,0,18,0.00018
JAMande12,,,0,1,1,0,2,2,1,1,1,0,95,0.00018
JAVAti1989,,,0,1,1,0,3,3,1,1,1,0,18,0.00018
JAbdullah01,,,0,1,1,0,1,1,1,1,1,0,158,0.00018
JAshtarany,,,0,1,1,0,4,4,1,1,1,0,18,0.00018
JCDtd3KmoV70bvu,,,1,3,4,2,5,7,1,1,1,0,217,0.00018
AkbariHassan7,,,1,0,1,2,0,2,0,0,0,0,217,0.000232
ashkanliberal,,,1,0,1,1,0,1,0,0,0,0,217,0.000232
JC_Constantine,,,0,3,3,0,3,3,2,0.6,0.666667,0,18,0.00018
JEnEl15928009,,,0,3,3,0,3,3,1,1,1,0,77,0.00018
JIqL1F94G8OIW0k,,,0,1,1,0,1,1,1,1,1,0,218,0.00018
Ahmad_Zaki22,,,1,0,1,1,0,1,0,0,0,0,218,0.000334
JLayegh,,,0,1,1,0,1,1,1,1,1,0,12,0.00018
JPadash,,,0,1,1,0,4,4,1,1,1,0,73,0.00018
JVD_CH,,,0,4,4,0,8,8,1,1,1,0,95,0.00018
JVVatson,,,0,2,2,0,4,4,1,1,1,0,18,0.00018
JYSM65,,,0,1,1,0,1,1,1,1,1,0,95,0.00018
J_r_nimo,,,0,2,2,0,4,4,3,0.464286,0.525641,0,18,0.00018
Ja_zarif,,,0,5,5,0,9,9,1,1,1,0,95,0.00018
pouriya_fazel68,,,1,0,1,1,0,1,0,0,0,0,95,0.000211
JaburiM,,,0,1,1,0,2,2,1,1,1,0,219,0.00018
gameboland,,,1,0,1,2,0,2,0,0,0,0,219,0.000334
JahaanGardd,,,0,1,1,0,1,1,1,1,1,0,220,0.00018
amojoey,,,1,0,1,1,0,1,0,0,0,0,220,0.000334
Jahadi313,,,0,1,1,0,3,3,1,1,1,0,95,0.00018
Jahan69Mohammad,,,0,2,2,0,3,3,1,1,1,0,95,0.00018
Jalal00203461,,,0,1,1,0,1,1,1,1,1,0,95,0.00018
JamPayam,,,0,1,1,0,1,1,1,1,1,0,77,0.00018
JamalRezaie,,,0,1,1,0,1,1,1,1,1,0,18,0.00018
Jamandeh313,,,0,1,1,0,2,2,1,1,1,0,95,0.00018
JananMshz,,,0,1,1,0,1,1,3,0.427273,0.450355,0,95,0.00018
Jandarm5,,,0,3,3,0,5,5,2,0.714286,0.8,0,18,0.00018
JaneMaryamJan,,,0,2,2,0,3,3,1,1,1,0,18,0.00018
JangaleSherwood,,,0,1,1,0,2,2,1,1,1,0,18,0.00018
Janz_Weit_Dr,,,0,4,4,0,7,7,1,1,1,0,18,0.00018
vida_vidvid,,,1,0,1,3,0,3,0,0,0,0,18,0.000219
JasAletheia,,,0,1,1,0,1,1,1,1,1,0,18,0.00018
JasinRamin,,,0,2,2,0,3,3,1,1,1,0,77,0.00018
JasmineElling14,,,0,1,1,0,2,2,1,1,1,0,221,0.00018
Soorena_bahram,,,1,0,1,2,0,2,0,0,0,0,221,0.000334
Javabdan,,,0,1,1,0,2,2,1,1,1,0,18,0.00018
JavadNasirian,,,0,1,1,0,2,2,1,1,1,0,95,0.00018
JavadRah,,,0,1,1,0,2,2,1,1,1,0,222,0.00018
Abo_fatemeh0,,,1,0,1,2,0,2,0,0,0,0,222,0.000334
JavadT888,,,0,1,1,0,2,2,1,1,1,0,95,0.00018
Javad__Abedi,,,0,1,1,0,1,1,1,1,1,0,95,0.00018
Javid_diba,,,0,1,1,0,1,1,1,1,1,0,18,0.00018
Javidan_Guard,,,0,2,2,0,2,2,1,1,1,0,18,0.00018
JaziniMahsa,,,0,2,2,0,4,4,1,1,1,0,77,0.00018
Je_suis_Ehsan,,,0,11,11,0,17,17,2,0.689655,0.775,0,18,0.00018
hzakarami,,,1,0,1,1,0,1,0,0,0,0,18,0.000194
roj_rouge,,,1,0,1,1,0,1,0,0,0,0,18,0.000194
JeanBaptiste912,,,0,7,7,0,15,15,1,1,1,0,95,0.00018
phoenix_hotline,,,1,0,1,2,0,2,0,0,0,0,95,0.000202
Jedilordkyloren,,,0,2,2,0,2,2,1,1,1,0,18,0.00018
Jeffandsimon,,,0,1,1,0,1,1,1,1,1,0,12,0.00018
JeffreyAdvocate,,,0,1,1,0,2,2,1,1,1,0,18,0.00018
Jelvegah,,,0,1,1,0,1,1,1,1,1,0,77,0.00018
Jenaze1,,,0,1,1,0,2,2,1,1,1,0,95,0.00018
Jerusha_68,,,0,2,2,0,2,2,1,1,1,0,77,0.00018
Jesus19753198,,,0,1,1,0,2,2,1,1,1,0,95,0.00018
MOHAMADMOEIN,,,1,0,1,2,0,2,0,0,0,0,95,0.000191
dideban1357,,,1,0,1,4,0,4,0,0,0,0,95,0.000191
nazarifarhodi,,,1,0,1,2,0,2,0,0,0,0,95,0.000191
roodavar,,,1,0,1,3,0,3,0,0,0,0,95,0.000191
JodeyriSepideh,,,0,1,1,0,1,1,1,1,1,0,77,0.00018
JoelMorgan1979,,,0,1,1,0,2,2,1,1,1,0,18,0.00018
Joker23374718,,,0,1,1,0,2,2,1,1,1,0,18,0.00018
JoliaPetrus,,,0,3,3,0,10,10,1,1,1,0,95,0.00018
PPakajaki,,,1,0,1,6,0,6,0,0,0,0,95,0.000232
Joojooirani,,,0,13,13,0,20,20,1,1,1,0,18,0.00018
ManotoNews,,,1,0,1,1,0,1,0,0,0,0,18,0.000192
Shapoor74,,,1,0,1,1,0,1,0,0,0,0,18,0.000192
Jooya1992,,,0,1,1,0,2,2,1,1,1,0,18,0.00018
JoseRcadio,,,0,2,2,0,3,3,1,1,1,0,77,0.00018
JudgeFace,,,0,14,14,0,22,22,2,0.769231,0.85,0,18,0.00018
KillBillGhates,,,1,2,3,1,3,4,1,1,1,2,18,0.000191
JunSomaye,,,0,1,1,0,2,2,1,1,1,0,77,0.00018
Jup986,,,0,1,1,0,1,1,1,1,1,0,18,0.00018
JustPedram,,,0,1,1,0,1,1,1,1,1,0,77,0.00018
Justrestart31,,,0,3,3,0,3,3,1,1,1,0,28,0.00018
Jz_hossein,,,0,2,2,0,3,3,1,1,1,0,77,0.00018
smrasnafi,,,1,0,1,2,0,2,0,0,0,0,77,0.000257
K61089176,,,0,3,3,0,3,3,1,1,1,0,95,0.00018
K91Ol,,,0,2,2,0,4,4,1,1,1,0,18,0.00018
KANDID3463,,,0,2,2,0,4,4,1,1,1,0,18,0.00018
KAchalKHane,,,0,11,11,0,13,13,5,0.375839,0.489881,0,18,0.00018
KEIVANA8A,,,0,1,1,0,1,1,3,0.4375,0.5,0,18,0.00018
KEf58105728,,,0,1,1,0,2,2,1,1,1,0,223,0.00018
shakibifard,,,1,0,1,2,0,2,0,0,0,0,223,0.000334
KFarhmand,,,0,1,1,0,1,1,1,1,1,0,18,0.00018
KG0W48Y7,,,0,4,4,0,12,12,2,0.833333,0.9,0,18,0.00018
KGDajXaRmSaZn8h,,,0,2,2,0,2,2,1,1,1,0,18,0.00018
KHlLwbCHeqH3u7B,,,0,1,1,0,1,1,1,1,1,0,95,0.00018
KMoghassem,,,0,1,1,0,1,1,1,1,1,0,77,0.00018
KOHSLAIMAN_NEWS,,,0,1,1,0,1,1,1,1,1,0,158,0.00018
KRaadmanesh,,,0,3,3,0,4,4,2,0.8,0.875,0,18,0.00018
KSajjad11,,,0,5,5,0,6,6,1,1,1,0,18,0.00018
K_Yazdgerd,,,0,4,4,0,5,5,2,0.7,0.785714,0,18,0.00018
KabirAidin,,,0,1,1,0,1,1,1,1,1,0,18,0.00018
KabiriHosein,,,0,1,1,0,3,3,1,1,1,0,224,0.00018
sad_news8,,,1,0,1,3,0,3,0,0,0,0,224,0.000334
Kafkasho,,,0,1,1,0,1,1,1,1,1,0,77,0.00018
Kafshande,,,0,1,1,0,1,1,1,1,1,0,95,0.00018
Kaftaresaghakh1,,,0,4,4,0,10,10,1,1,1,0,95,0.00018
mighat313,,,1,0,1,2,0,2,0,0,0,0,95,0.000219
Kahfalhasin,,,0,2,2,0,4,4,2,0.625,0.7,0,95,0.00018
KahkshanRaha,,,0,1,1,0,2,2,1,1,1,0,95,0.00018
KalForDoc,,,0,1,1,0,1,1,1,1,1,0,18,0.00018
KalantariMoein,,,0,1,1,0,2,2,1,1,1,0,95,0.00018
KamalDarvish,,,0,8,8,0,10,10,1,1,1,0,18,0.00018
endebonbast,,,1,0,1,1,0,1,0,0,0,0,18,0.0002
KamaliSajad,,,0,2,2,0,5,5,1,1,1,0,77,0.00018
KambizAsef,,,0,4,4,0,5,5,1,1,1,0,95,0.00018
Kambiz__50,,,0,1,1,0,1,1,1,1,1,0,77,0.00018
Kamlidpv,,,0,2,2,0,3,3,1,1,1,0,77,0.00018
Kamrankazemi191,,,0,1,1,0,1,1,1,1,1,0,225,0.00018
kamrani,,,1,0,1,1,0,1,0,0,0,0,225,0.000334
Kamyarsabahi,,,0,1,1,0,1,1,1,1,1,0,18,0.00018
Karamat28762169,,,0,1,1,0,1,1,1,1,1,0,18,0.00018
KarapetianArad,,,0,9,9,0,15,15,5,0.351562,0.471481,0,18,0.00018
Kardan_Plus,,,0,1,1,0,2,2,1,1,1,0,95,0.00018
Karimderis1,,,0,1,1,0,1,1,1,1,1,0,95,0.00018
KarimiPooran,,,0,2,2,0,2,2,1,1,1,0,12,0.00018
KarimizadeMajid,,,0,2,2,0,6,6,1,1,1,0,95,0.00018
Kasbarg_m_ch,,,1,1,2,2,2,4,0,0,0,0,226,0.00018
KashiDige,,,0,1,1,0,1,1,1,1,1,0,77,0.00018
KashifrafiqPTI,,,0,1,1,0,1,1,1,1,1,0,158,0.00018
Kasra818,,,0,3,3,0,5,5,1,1,1,0,12,0.00018
Kathypak5,,,0,3,3,0,3,3,2,0.666667,0.75,0,18,0.00018
eagle_eye92,,,2,0,2,2,0,2,0,0,0,0,18,0.000386
KavKavnas,,,0,2,2,0,2,2,1,1,1,0,12,0.00018
KavehAhangar348,,,0,1,1,0,1,1,1,1,1,0,18,0.00018
KavehGoudarzi,,,0,1,1,0,1,1,1,1,1,0,227,0.00018
amirtaher61,,,1,0,1,1,0,1,0,0,0,0,227,0.000334
KavehKasraei,,,0,1,1,0,2,2,1,1,1,0,18,0.00018
Kavehdeldar1,,,0,1,1,0,1,1,1,1,1,0,228,0.00018
Sori60188930,,,1,0,1,1,0,1,0,0,0,0,228,0.000334
KazemSafarpanah,,,0,3,3,0,10,10,1,1,1,0,95,0.00018
KazemiKoorosh,,,0,2,2,0,2,2,1,1,1,0,18,0.00018
KazeraniAzadeh,,,0,1,1,0,1,1,1,1,1,0,18,0.00018
KebariMr,,,0,1,1,0,1,1,1,1,1,0,95,0.00018
Keeny777,,,0,3,3,0,4,4,1,1,1,0,18,0.00018
sobhan_a1,,,1,0,1,1,0,1,0,0,0,0,18,0.000232
Kelishe,,,0,1,1,0,1,1,1,1,1,0,77,0.00018
Ken_master47,,,0,1,1,0,1,1,1,1,1,0,18,0.00018
KeramatiHadi,,,0,1,1,0,2,2,1,1,1,0,34,0.00018
KermaniMahya,,,0,2,2,0,2,2,2,0.75,0.833333,0,95,0.00018
twittzadeh,,,1,0,1,1,0,1,0,0,0,0,95,0.000257
KetaminPropofol,,,0,1,1,0,1,1,1,1,1,0,229,0.00018
HamidSoh,,,1,0,1,1,0,1,0,0,0,0,229,0.000334
Keykavoskochk,,,0,2,2,0,2,2,1,1,1,0,18,0.00018
Keysey12,,,0,1,1,0,1,1,1,1,1,0,77,0.00018
Kh__Eli,,,0,1,1,0,2,2,2,0.666667,0.75,0,18,0.00018
KhachKavor,,,0,1,1,0,2,2,2,0.666667,0.75,0,18,0.00018
Khadem66,,,0,1,1,0,1,1,1,1,1,0,77,0.00018
Khademehshohad1,,,0,1,1,0,2,2,1,1,1,0,95,0.00018
KhadmGomnam,,,0,5,5,0,9,9,1,1,1,0,95,0.00018
SANDBAD_20,,,1,0,1,1,0,1,0,0,0,0,95,0.000211
KhalajSina,,,0,1,1,0,1,1,1,1,1,0,77,0.00018
KhalePajal,,,1,15,16,14,37,51,2,0.85,0.911765,0,18,0.00018
Bizhan253,,,1,0,1,1,0,1,0,0,0,0,18,0.000191
per6ianjoker,,,1,0,1,1,0,1,0,0,0,0,18,0.000191
KhandanSeyd,,,0,1,1,0,1,1,1,1,1,0,18,0.00018
KhanomLabkhand,,,0,2,2,0,3,3,1,1,1,0,77,0.00018
Kharabatnadide,,,0,1,1,0,2,2,1,1,1,0,18,0.00018
Khatoon_hastam,,,0,2,2,0,3,3,1,1,1,0,18,0.00018
Khatoonkhh11,,,0,10,10,0,16,16,3,0.477876,0.546296,0,77,0.00018
Sana5713,,,1,0,1,2,0,2,0,0,0,0,77,0.000196
agha_zan,,,1,0,1,2,0,2,0,0,0,0,77,0.000196
alisoltanivash,,,1,0,1,2,0,2,0,0,0,0,77,0.000196
dokhtareshahid,,,1,0,1,2,0,2,0,0,0,0,77,0.000196
namira63,,,1,0,1,1,0,1,0,0,0,0,77,0.000196
Khavary_mostafa,,,0,1,1,0,5,5,1,1,1,0,95,0.00018
Khazar14,,,0,1,1,0,1,1,1,1,1,0,12,0.00018
soldier_on_line,,,1,0,1,1,0,1,0,0,0,0,95,0.000287
Khom57,,,0,2,2,0,3,3,1,1,1,0,95,0.00018
Khonsard,,,0,3,3,0,4,4,1,1,1,0,77,0.00018
Khorshidkmg,,,0,2,2,0,2,2,2,0.75,0.833333,0,18,0.00018
KhoshBayan,,,0,1,1,0,1,1,1,1,1,0,77,0.00018
Khosro_mn,,,0,1,1,0,1,1,1,1,1,0,18,0.00018
Khosrow16857180,,,0,2,2,0,2,2,1,1,1,0,12,0.00018
Kia67509963,,,0,1,1,0,1,1,1,1,1,0,95,0.00018
KianShl,,,0,1,1,0,1,1,1,1,1,0,18,0.00018
Kianbano,,,0,1,1,0,1,1,1,1,1,0,18,0.00018
